---------------
---------------
-o--o--o-------
-#--#--#--#----
----------#----
----------#o---
----------#o---
----------#o---
---XgggX--#----
---XXXXX--#----
----------#----
----------#----
----------#gF--
----------###--
XX--------XXXXX
XX--------XXXXX