---------------
---------------
---------------
-------o--o----
---------------
---------------
-------#-------
-----g##-------
-----###-------
---g####-------
---#####-------
-g######-------
-#######----F--
########----#--
XXXXXXXXXXXXXXX
XXXXXXXXXXXXXXX