---------------
---------------
---------------
---------------
---------------
-------o-------
-------#-------
------##-------
----o-##-------
----#-##-------
---##-##-------
--###-##-------
o-###-##----F--
#-###-##g--g#--
X-XXX-XXXXXXXXX
X-XXX-XXXXXXXXX