---------------
---------o-----
---------o-----
---------D-----
--------D------
-------D-------
---------------
-DDDD----------
---------D-----
D--------D-----
---------D-----
---------------
------------F--
------------#--
XXXXXXXXXXXXXXX
XXXXXXXXXXXXXXX