---------------
---------------
-----------o---
-----G--G-D-D--
-DDDDDDDDDDoD--
-DDDDDDDDDD-D--
----------DoD--
D---------D-D--
----------DoD--
----------D-D--
----------DoD--
----------D-D--
----------Do---
----------D----
----------XXXXX
----------XXXXX