---------------
---------------
---------------
------------G--
-DDD--------DD-
-DDD--------DD-
---D--------D--
D---Dg----gD--D
-----D----D----
------DooD-----
------DooD-----
------DooD-----
-------DD------
---------------
---------------
---------------
