---------------
---------------
---------------
---------------
---------------
---------------
---------------
---------------
------o--------
-----o-o-------
----o-o-o------
K--o-o-o-o--K--
D---D---D---D--
--D---D---D----
XXXXXXXXXXXXXXX
XXXXXXXXXXXXXXX