---------------
-------------L-
---------------
------------K--
---------%%%%%-
---------%%%%%-
-----------||--
---k---k---||--
-%%%%%%%%%%%%%-
-%%%%%%%%%%%%%-
-------||------
-------||------
-------||------
-------||------
-------||------
-------||------