-----U---------
---------------
-----D---------
-------D-------
-----D---------
-------D-------
D----D---------
D--g--g--------
DDDDDDDD-------
--------D------
---------D-----
---ooo----D----
---o-o-----D---
---ooo------D--
-------------XX
-------------XX