---------------
---------------
---------------
---M---X--gX-g-
XXXXXXXXXXXXXX-
XXXXXXXXXXXXXX-
-------------X-
-------------X-
---------------
---------------
-D-D-DD--D-D-DD
-D-D-D-D-D-D-D-
-DD--DD--D-D-DD
-D-D-D-D--D---D
-D-D-D-D--D--DD
---------------