---------------
---------------
---------------
---------------
---------------
---------------
o--------------
X--------------
X--------------
X--------o-----
X--------o-----
X--------o-----
XX-------------
XX-M-D--gD-gD-g
XXXXXXXXXXXXXXX
XXXXXXXXXXXXXXX