---------------
---------------
---------------
---------------
---------------
---------------
---------------
---------------
X------o--o----
X------o--o----
X--------------
X------!--!----
X--------------
X--M--------g-g
XXXXXXXXXXXXXXX
XXXXXXXXXXXXXXX