---------------
---------------
--------!--!---
---------------
---------------
X-------!--!---
X--------------
X--M-----------
XXXXXoXXoXXoXX-
XXXXXXXXXXXXXX-
XXXXXXXXXXXX---
XXXXXXXXX------
XXXXXX---------
XXX------------
XX-------------
X--------------