---------------
---------------
--------!--!---
---------------
---------------
--------!--!---
---------------
---M---------k-
XXXXXXXXXXXXXX-
XXXXXXXXXXXXXX-
---------------
---------------
---------------
---------------
---------------
---------------