----------------------------------------------D------------D-----------------D---------D--DD----------------------------------------------------------
----------------------------------------------D------------D-----------------D---------D---D----------------------------------------------------o-----
-----------------------------#----------------D------------D-----------------D---------D---D-------------------------YYY------------------------o-----
---M---X--gX-g---------------#----------------D------------D-----------------D---------D---D-------------------------DDD------------------------D-----
XXXXXXXXXXXXXX--------------------------------D------------D-----------------D---------D---D---------------------------D-----------------------D------
XXXXXXXXXXXXXX------------#-------------------D------------D-----------------D---------D---D---------------------------D----------------------D-------
-------------X------------#-------------------D------------D--------------D--D---------D---D-------------------------D-D------------------------------
-------------X------------#-------------------D------------D-------------YD--D---------D---D----------D--------------o-D--------------o-DDDD----------
-----------------------------#----------------D------------D-------------DD--D---------D---D-----------------ooo-----o-D--------------D---------D-----
-----------------------------#----------------D------------D--------------D--DDDDDDDDDDD---DDDDDDDDDDDD---DD-DDDD-DDDDDD--------------DD--------D-----
-D-D-DD--D-D-DD--------------#----------------DDDDDDDDDDDDD---------g-g-g-D-------------------------D---X-----------------o---------------------D-----
-D-D-D-D-D-D-D--------oo----##---------------------oo-----------DDDDDDDDDDD----------------o--------D---X-----------------o----------*----------------
-DD--DD--D-D-DD---#---##---###-D-----*-----D-------------------D----------D------ooo---oo--*----------o-X-----------------o-------*--D-------------F--
-D-D-D-D--D---DX--#--y--y--###-D-----D-----D--k--y----y-------D-----------D-------y--Y--y--D----r-----*-X---------------------k---D--D-------------#--
-D-D-D-D--D--DDXXXXXXXXXXXXXXXXXXXXXXXXXXXXXXXXXXXXXXXXXXXXXXXXXXXXXXXXXXXXXXXXXXXXXXXXXXXXXXXXXXXXXXXXXX---------------XXXXXXXXXXXXXXXXXXXXXXXXXXXXXX
---------------XXXXXXXXXXXXXXXXXXXXXXXXXXXXXXXXXXXXXXXXXXXXXXXXXXXXXXXXXXXXXXXXXXXXXXXXXXXXXXXXXXXXXXXXXX---------------XXXXXXXXXXXXXXXXXXXXXXXXXXXXXX
