------------------------------------------------------------------------------------------------------------------------------------------------------
------------------------------------------------------------------------------------------------------------------------------------------------------
--------!--!------------------------------------------------------------------------------------------------------------------------------------------
-------------------------------------------------------------------------------------------------------D--------------------------------------o--o----
--------------------------------------------------------------------------g---------------------------DD----------------------------------------------
--------!--!-----------------------------------------------D------------DDD--------------D-o-------oo--D------------------------------D---------------
----------------------------------------------------------------------TTDD-----------------o-------TT--D--------------------------------------#-------
---M---------k--------------------------------------------------------tt-------------------o-------tt--D------------------------------------g##-------
XXXXXXXXXXXXXX-----------------------------------------TT-------g-g---tt-------------TT----o--oo-------D--------------------------TT--------###-------
XXXXXXXXXXXXXX---------------X-------------------------tt---XXXXXXXTTXXXXXX----------tt----o--TT-------D--------o-----------------tt------g####-------
---------------------TT-----XX---------------------TToott---XXXXXXXttXXXXXX------TToott----o--tt---oo--D--------o-------------TToott------#####-------
--------------------otto-----X-------C-S-S-C-------ttoott----------tt------------ttoott----o-------TT--D-----o--o--o----------ttoott----g######-------
--------------------otto-----X---------------------ttoott----------tt------------ttoott------------tt--D----o-------o---------ttoott----#######----F--
---------------X-X--otto--X-X--------ooo-----------ttggtt----------tt------------ttggtt--------g---tt--D--------r-------------ttggtt---########----#--
---------------XXXXXXXXXXXXXXXXXXX--XXXXX-XXXXXXXXXXXXXXXXXX-------tt------XXXXXXXXXXXXXXXX---XX-X--XX-XXX------X-----TTXXXXXXXXXXXXXXXXXXXXXXXXXXXXXX
---------------XXXXXXXXXXXXXXXXXXX--XXXXX-XXXXXXXXXXXXXXXXXX-------tt------XXXXXXXXXXXXXXXX---XX-X--XX-XXX------X-----ttXXXXXXXXXXXXXXXXXXXXXXXXXXXXXX
