----------------D------------D-------------------------------------------------------------D-------------DD-------------------------------------------
----------------D------------D-------------------------------------------------------------D--------------D--------------------o----------------------
----------------D------------D-------------------------------------------------------------D--------------D--------------------o----------------------
---M---X--gX-g--DD----*----DD--------------------------------------------------------------D--------------D--------------------o----------------------
XXXXXXXXXXXXXX--------D------------------------------------g-------------------------------D--------------D--------------------o----------------------
XXXXXXXXXXXXXX--------D----------------------------------DDD--------------D----------------D--------------D-------------------*D*-------------o-------
-------------X--XXXXXXXXXXXXX--------------------------TTDD--------------------------------D------o-------D--------------------*--------------#-------
-------------X-----------------------------------------tt----------------------------------D-----o-o------D----------D--------*D*------------##-------
-------------------------------------------------g-g---tt-------------TT---------o---------D----o-o-o-----D--------------TT-TTDDDTT-TT-----o-##-------
--------------------------------------------XXXXXXXXTTXXXXXX----------tt--------o-o--------DDDDDDDDDDDDD--DDDDDDDDDDDD---DDDDDD--DDDDD-----#-##-------
-D-D-DD--D-D-DD---------------------TT-----XXXXXXXXXttXXXXXX------TToott-------o-o-o-------------------------------D---X------------------##-##-------
-D-D-D-D-D-D-D---------------------otto-----X-------tt------------ttoott------o-o-o-o---------------------o--------D---X-----------------###-##-------
-DD--DD--D-D-DD--------------------otto-----X-------tt------------ttoott---D-----|-------D------TT--------*----------o-X---------------o-###-##----F--
-D-D-D-D--D---D---------------X-X--otto--X-X--------tt------------ttggtt---X-k---|----k--X------tt--------D----r-----*-X---------------#-###-##g--g#--
-D-D-D-D--D--DD---------------XXXXXXXXXXXXXXX-------tt------XXXXXXXXXXXXXXXXXXXXXXXXXXXXXX--TT--tt---TT--XXXXXXXXXXXXXXX---------------X-XXX-XXXXXXXXX
------------------------------XXXXXXXXXXXXXXX-------tt------XXXXXXXXXXXXXXXXXXXXXXXXXXXXXXX-tt--tt---tt--XXXXXXXXXXXXXXX---------------X-XXX-XXXXXXXXX
