-------------------------------D------------D-------------------------------------------------------------D-------------------------------------------
-------------------------------D------------D-------------------------------------------------------------D-------------------------------------------
-------------------------------D------------D-------------------------------------------------------------D-------------------------------------------
-------------------------------D------------D-------------------------------------------------------------D-------------------------------------o-----
-------------------------------D------------D-------------------------------------------------------------D------------------------------------o------
-------------------------------D------------D-------------------------------------------------------------D-----------------------------------o-------
-------------------------------D------------D-------------------------------------------------------------D-----------------------------------#-------
-------------------------------D------------D-------------------------------------------------------------D----------------------------------##-------
X------o--o--------------------D------------D-------D-------------o--------------o------------------------DDDDDDDDDDD------------------------##-------
X------o--o--------------------D------------D--SSS@SSSS---D------o-o------------o-o---------------o-----------------------------o---------o--##-------
X------------------------------DDDDDDDDDDDDD----------S---D-----o-o-o----------o-o-o--------------o-----------------------------o---------#--##-------
X------!--!-----------C-S-S-C-------oo-----------------SSSD----o-o-o-o-----K--o-o-o-o--K----------o-----------o--------Y--------o--------##--##-------
X----------------------------------------------oo-------ooD-D-----|-------DD---D---D---D----------o-----------o--------Y--------o--------##--##----F--
X--M--------g-g-------ooo------k--y----y-------oo--g----ooD-X-k---|----k--X--D---D---D------------o-----------o-----Dy-D--------o------#-##--##----#--
XXXXXXXXXXXXXXXXXXX--XXXXX-XXXXXXXXXXXXXXXXXXXXXXXXXXXXXXXXXXXXXXXXXXXXXXXXXXXXXXXXXXXXXXXX-------X-----XX----X-----XXXXX-------X-----XX-XX--XXXXXXXXX
XXXXXXXXXXXXXXXXXXX--XXXXX-XXXXXXXXXXXXXXXXXXXXXXXXXXXXXXXXXXXXXXXXXXXXXXXXXXXXXXXXXXXXXXXX-------X-----XX----X-----XXXXX-------X-----XX-XX--XXXXXXXXX
