----------------------------------------------------X--------------------------------------------------------------------D------------D---------------
----------------------------------------------------X--------------------------------------------------------------------D------------D---------------
--------!--!----------------------------------------X---------------------------------------------------#----------------D------------D---------------
----------------------------------------------------X---------------------------------------------------#--------oo---oo-D------------D---------o-----
----------------------------------------------X------X-----------------------------------------------------------YY---YY-D------------D--------o------
X-------!--!--------------------------------X-XX---XXXX----X-----------------------------------------#----DDD----DD---DD-D------------D-------o-------
X-------------------------------------------X-XX---XXXXX--XX-----------------------------------------#---------------o---D------------D-------#-------
X--M---------------------------------------XX-XX---XXXXX---X-----------------------------------------#---------------o---D------------D------##-------
XXXXXoXXoXXoXX-----oooo-----g--XXX--XXXXX-XXX-XX--oXXXXX---X------o---------------D---------------------#------------o---D------------D------##-------
XXXXXXXXXXXXXX-##--####--#####-XXX--XXXXX-XXX-XX--oXXXXXX--X-----o-o---------SSS@SSSS---D---------------#------D-----D---D------------D---o--##-------
XXXXXXXXXXXX----#-y#--#-y#-----------------oX-XX---o-------X----o-o-o---------------S---D---------------#----------------DDDDDDDDDDDDD----#--##-------
XXXXXXXXX--------##----##-----X------------oX-XX---o-------X---o-o-o-o---------------SSSD--------oo----##---------------------oo---------##--##-------
XXXXXX------------------------X------------oX-XX---XXX-XXXXXD-----|-------D--oo-------ooD----#---##---###--------------------------------##--##----F--
XXX-----------------------------------g----oX-XX----XX-XXXXXX-k---|----k--X--oo--g----ooD-X--#--y--y--###----------------k--y----y-----#-##--##----#--
XX----------------------------XXXX--XXXXX-XXX-XX----XX-XXXXXXXXXXXXXXXXXXXXXXXXXXXXXXXXXXXXXXXXXXXXXXXXXX---------------XXXXXXXXXXXXXXXX-XX--XXXXXXXXX
X-----------------------------XXXX--XXXXX-XXX-XX----XX-XXXXXXXXXXXXXXXXXXXXXXXXXXXXXXXXXXXXXXXXXXXXXXXXXX---------------XXXXXXXXXXXXXXXX-XX--XXXXXXXXX
