---------------------------------------------------U------------------------------------------------------D-------------------------------------------
----------------------------------------------------------------------------------------------------------D-------------------------------------------
---------------------------------------------------D--------------------------------------------------YYY-D-------------------------------------------
-----------------------------------------------------D------------------------------------------------DDD-D-------------------------------------o-----
---------------------------------------------------D----------------------------------------------------D-D------------------------------------o------
-----------------------------------------------------D--------------------D--------------D--------------D-D---------------------------D-------o-------
---------------------------------------------------D--------------------------------------------------D-D-D------o----------------------------#-------
------------------------------------------------r------r----------------------------------------------o-D-D-----o-o--------------------------##-------
X------o--o-----------------------oooo-----g-%%%%%%%%%%%%%%%----------TT-------------TT-------ooo-----o-D-D----o-o-o--------------TT---------##-------
X------o--o------------------X##--####--#####%%%%%%%%%%%%%%%----------tt-------------tt----DD-DDDD-DDDDDD-DDDDDDDDDDDDD-----------tt------o--##-------
X--------------------TT-----XX-#-y#--#-y#-----------||------------TToott---------TToott---------------------------------------TToott------#--##-------
X------!--!---------otto-----X--##----##------------||------------ttoott---------ttoott---------------------------------------ttoott-----##--##-------
X-------------------otto-----X----------------------||------------ttoott---------ttoott------------------------TT-------------ttoott-----##--##----F--
X--M--------g-gX-X--otto--X-X-----------------------||------------ttggtt---------ttggtt------------------------tt-------------ttggtt---#-##--##----#--
XXXXXXXXXXXXXXXXXXXXXXXXXXXXXX----------------------||------XXXXXXXXXXXXXXXXXXXXXXXXXXXXXX-----------------TT--tt---TT--XXXXXXXXXXXXXXXX-XX--XXXXXXXXX
XXXXXXXXXXXXXXXXXXXXXXXXXXXXXX----------------------||------XXXXXXXXXXXXXXXXXXXXXXXXXXXXXX---------------X-tt--tt---tt--XXXXXXXXXXXXXXXX-XX--XXXXXXXXX
