--------------------------------------------------U----------D------------------------------D---------D---D------------D------------------------------
-------------------------------------------------------------D------------------------------D---------D---D------------D------------------------o-----
--------!--!--------------------------------#-----D----------D------------------------------D---------D---D------------D------------------------o-----
--------------------------------------------#-------D--------D------------------------------D---------D---D------------D------------------------D-----
--------------------------------------------------D----------D------------------------------D---------D---D------------D-----------------------D------
--------!--!-----------------------------#----------D--------D---------------------------D--D---------D---D------------D----------------------D-------
-----------------------------------------#---D----D----------D------o-----------------------D---------D---D------------D------------------------------
---M---------k---------------------------#---D--g--g---------D-----o-o----------------------D---------D---D------------D----------------DDDD----------
XXXXXXXXXXXXXX------------------------------#DDDDDDDD--------D----o-o-o--------------TT-----D---------D---D------------D------------------------D-----
XXXXXXXXXXXXXX---------------X--------------#--------D-------DDDDDDDDDDDDD-----------tt-----DDDDDDDDDDD---D------------D--------------XD--------D-----
---------------------TT-----XX--------------#---------D--------------------------TToott-------------------DDDDDDDDDDDDD-------TT-----XX---------D-----
--------------------otto-----X-------oo----##---ooo----D-------------------------ttoott------------------------oo------------otto-----X---------------
--------------------otto-----X---#---##---###---o-o-----D---------TT-------------ttoott---------ooo---oo---------------------otto-----X------------F--
---------------X-X--otto--X-X-X--#--y--y--###---ooo------D--------tt-------------ttggtt----------y--Y--y--k--y----y-----X-X--otto--X-X-------------#--
---------------XXXXXXXXXXXXXXXXXXXXXXXXXXXXXX-------------XX--TT--tt---TT--XXXXXXXXXXXXXXXXXXXXXXXXXXXXXXXXXXXXXXXXXXXXXXXXXXXXXXXXXXXXXXXXXXXXXXXXXXX
---------------XXXXXXXXXXXXXXXXXXXXXXXXXXXXXX-------------XXX-tt--tt---tt--XXXXXXXXXXXXXXXXXXXXXXXXXXXXXXXXXXXXXXXXXXXXXXXXXXXXXXXXXXXXXXXXXXXXXXXXXXX
