---------------------------------------------------------------------------------------------------------DD-------------------------------------------
----------------------------------------------------------------------------------------------------------D-------------------------------------o-----
--------!--!----------------------------------------------------------------------------------------------D-------------------------------------o-----
----------------------------------------------------------------------------------------------------------D-------------------------------------D-----
----------------------------------------------------------------------------------------------------------D------------------------------------D------
X-------!--!----------------------------------------------------------------------------------------------D-----------------------------------D-------
X---------------------------------------------------------------------------------------------------------D-------------------------------------------
X--M-------------------------------------------------------------------------------------D----------------D----------D---------------o--DDDD----------
XXXXXoXXoXXoXX-------------------------------------o--------------o---------------------------------------D--------------X-----------2X---------D-----
XXXXXXXXXXXXXX------------------------o-----------o-o------------o-o--------------o----D------------------DDDDDDDDDDDD---X------------XD--------D-----
XXXXXXXXXXXX--------------------------o----------o-o-o----------o-o-o-------------o--------------o-----*D----------D---X-X-----------oX---------D-----
XXXXXXXXX-----------------------------o---------o-o-o-o-----K--o-o-o-o--K---------o------D-------o----ooD-o--------D---X-X-----------2X---------------
XXXXXX----------D-----*-----D---------o------D-----|-------DD---D---D---D---------o------Do------o----DDD-*----------o-X-X------------X------------F--
XXX-------------D-----D-----D---------o------X-k---|----k--X--D---D---D----D------r------Do------g-----*D-D----r-----*-X-X-r-----r----X------------#--
XX-------------XXXXXXXXXXXXXXXX-------X-----XXXXXXXXXXXXXXXXXXXXXXXXXXXXXXXXXX----D----XXXX------X-----XXXXXXXXXXXXXXXXXXXXX--XX-XX-XXXXXXXXXXXXXXXXXX
X--------------XXXXXXXXXXXXXXXX-------X-----XXXXXXXXXXXXXXXXXXXXXXXXXXXXXXXXXX---------XXXX------X-----XXXXXXXXXXXXXXXXXXXXX--XX-XX-XXXXXXXXXXXXXXXXXX
