------------------------------------------------------------------------------------------DDDDDDD------------------------D----------------------------
------------------------------------------------------------------------------------------------D------------------------D----------------------------
------------------------------------------------------------------------------------------------D------------------------D----------------------------
------------------------------------------------------------------------------------------------D------------------------D----------------------------
-----------------------------------------------------------------oo-------------oo--------------D------------------------D----------------------------
------------------------------------------------------------------------oX-------------oX--X--ooD------------------------D--------------------o-------
------------------------------------------------------------------------oX-------------oX--X--ooD------------------------D------o-------------#-------
-----------------------------------------------------------D------------XX-------------XX--X---o-------------------------D-----o-o-----------##-------
X------o--o--------------------------------------------------XXX----XX--XX--XXX----XX--XX--X---o--------o----------------D----o-o-o--------o-##-------
X------o--o------------------X----------------------o----D---XXX----XX--XX--XXX----XX--XX--X------------D-------o--------DDDDDDDDDDDDD-----#-##-------
X--------------------TT-----XX----------------------o----------X---------X----X---------X--X--------------------o-------------------------##-##-------
X------!--!---------otto-----X-------C-S-S-C--------o------DX--X---------X-X--X---------X--X---------o-------o--o--o---------------------###-##-------
X-------------------otto-----X----------------------o------DX--X---------X-X--X---------X--X---------D------o-------o---------TT-------o-###-##----F--
X--M--------g-gX-X--otto--X-X--------ooo-----D------r------D---X---------X----X---------X--X--------------------r-------------tt-------#-###-##g--g#--
XXXXXXXXXXXXXXXXXXXXXXXXXXXXXXXXXX--XXXXX-XXXXXX----D----XXXXXXX---------X-XXXX---------X--X---DD--------X------X-----TT--TT--tt---TT--X-XXX-XXXXXXXXX
XXXXXXXXXXXXXXXXXXXXXXXXXXXXXXXXXX--XXXXX-XXXXXX---------XXXXXXX---------X-XXXX---------X--X-------------X------X-----ttX-tt--tt---tt--X-XXX-XXXXXXXXX
