------------------------------------------------------------------------------------------------DD--------D------------DDD----------------------------
------------------------------------------------------------------------------------------------DD--------D------------D-D----------------------------
------------------------------------------------------------------------------------------------DD--------D------------D-D----------------------------
------------------------------------------------------------------------------------------------DD--------D------------D-D----------------------------
-----------------------------------------------------------------oo-----------------------------DD--------D------------D-D----------------------------
------------------------------------------------------------------------oX----------------------DD--------D------------D-D--------------------o-------
o----------------------------------------------------------o------------oX----------------------DD--------D*-----------D-D--------------------#-------
X----------------------------D-----------------------------o------------XX---------------o------DD---------------------D-D----------D--------##-------
X----------------------------------------------------------o-XXX----XX--XX---------------D------DD--------X*-----------D-D-----------------o-##-------
X--------o------------o----D-------------------------------D-XXX----XX--XX---------------D-XX---DD----XX--XX*------k---D-DDDDDDDDDDDD------#-##-------
X--------o------------o------------------------o---------------X---------X---o-------------XX---DD----XX--XXXXXXXXXXXXo-----------D---X---##-##-------
X--------o------------o------D-----------------o----------*-X--X---------X---o----------*--D----------D--------------Xo--o--------D---X--###-##-------
XX--------------------o------D-D-----*-----D---o-------*--D-X--X---------X---o-------*--D--D---------*D--------------Xo--*----------o-Xo-###-##----F--
XX-M-D--gD-gD-gD------r------D-D-----D-----D------g--g-D--D----X---------X-------k---D--D--D*--oooo--D---------------Xo--D----r-----*-X#-###-##g--g#--
XXXXXXXXXXXXXXXXXX----D----XXXXXXXXXXXXXXXXXXXXXXXXXXXXXXXXXXXXX---------X-XXXXXXXXXXXXXXX--DDDDDDDDD----------------XXXXXXXXXXXXXXXXXXX-XXX-XXXXXXXXX
XXXXXXXXXXXXXXXXXX---------XXXXXXXXXXXXXXXXXXXXXXXXXXXXXXXXXXXXX---------X-XXXXXXXXXXXXXXX---------------------------XXXXXXXXXXXXXXXXXXX-XXX-XXXXXXXXX
