------------------------------------------------------------------------------------------DD----------------------------------------------------------
-------------------------------------------------------------------------------------------D----------------------------------------------------------
-------------------------------------------------------------------------------------------D----------------------------------------------------------
-------------------------------------------------------------------------------------------D--------------------------------------------------o--o----
--------------------------------------------------------------------------------oo---------D----------------------------------------------------------
---------------------------------------------------------------------------------------oX--D----------------------------------------------------------
---------------------------------------------------------------------------------------oX--D--------------------------------------------------#-------
-----------------------------------------------------------D--------------o------------XX--D----------D-------------------------------o-----g##-------
X------o--o---------------------------------------------------------------D-XXX----XX--XX--D------------------------------------------D-----###-------
X------o--o-----------------------------------------o----D----------------D-XXX----XX--XX--DDDDDDDDDDDD----------o--------------------D---g####-------
X---------------------------------------------------o---------o---------------X---------X-----------D---X--------o--------o---------------#####-------
X------!--!-----------C-S-S-C-----------------------o------D--o----------*-X--X---------X--o--------D---X--------o--------o----------*--g######-------
X------------------------------D-----*-----D--------o------D--o-------*--D-X--X---------X--*----------o-X--------o--------o-------*--D--#######----F--
X--M--------g-g-------ooo------D-----D-----D-D------r------D------k---D--D----X---------X--D----r-----*-X--------o------------k---D--D-########----#--
XXXXXXXXXXXXXXXXXXX--XXXXX-XXXXXXXXXXXXXXXXXXXXX----D----XXXXXXXXXXXXXXXXXXXXXX---------X-XXXXXXXXXXXXXXXX-------X-----XXXXXXXXXXXXXXXXXXXXXXXXXXXXXXX
XXXXXXXXXXXXXXXXXXX--XXXXX-XXXXXXXXXXXXXXXXXXXXX---------XXXXXXXXXXXXXXXXXXXXXX---------X-XXXXXXXXXXXXXXXX-------X-----XXXXXXXXXXXXXXXXXXXXXXXXXXXXXXX
