----------------------------------------------------------------------------------------------------------D-------------------------------------------
----------------------------------------------------------------------------------------------------------D-------------------------------------------
----------------------------------------------------------------------------------------------------------D-------------------------------------------
----------------------------------------------------------------------------------------------------------D-------------------------------------o-----
----------------------------------------------------------------------------------------------------------D------------------------------------o------
-----------------------------D----------------------------------------------------------------------------D-----------------------------------o-------
o---------------------------------------------------------------------------------------------------------D------o----------------------------#-------
X-------------------------------------------------------------------------D-------------------------------D-----o-o--------------------------##-------
X------------------------TT------------------------o------------------------------------------------------D----o-o-o-------------------------##-------
X--------o---------------tt-----------------------o-o--------------o----D----------------X-------o--------DDDDDDDDDDDDD---------o---------o--##-------
X--------o-----------TToott----------------------o-o-o-------------o-------------TT-----XX-------o------------------------------o---------#--##-------
X--------o-----------ttoott----------C-S-S-C----o-o-o-o------------o------D-----otto-----X----o--o--o---------------------------o--------##--##-------
XX-------------------ttoott------------------D-----|-------D-------o------D-----otto-----X---o-------o---------TT---------------o--------##--##----F--
XX-M-D--gD-gD-g------ttggtt----------ooo-----X-k---|----k--XD------r------DX-X--otto--X-X--------r-------------tt---------------o------#-##--##----#--
XXXXXXXXXXXXXXXXXXXXXXXXXXXXXXXXXX--XXXXX-XXXXXXXXXXXXXXXXXXXXX----D----XXXXXXXXXXXXXXXXXXX------X-----TT--TT--tt---TT--X-------X-----XX-XX--XXXXXXXXX
XXXXXXXXXXXXXXXXXXXXXXXXXXXXXXXXXX--XXXXX-XXXXXXXXXXXXXXXXXXXXX---------XXXXXXXXXXXXXXXXXXX------X-----ttX-tt--tt---tt--X-------X-----XX-XX--XXXXXXXXX
