----------------D--------------------------------------D-----D------------D---------------------DD-------DD---------------D---------D-----------------
----------------D--------------------o-----------------D-----D------------D---------------------DD--------D---------------D---------D-----------------
--------!--!----D--------------------------------------D-----D------------D--------------#------DD--------D---------------D---------D-----------------
----------------D------------D---#---y---#------#-----oD-----D------------D--------------#------DD--------D---------------D---------D---------o--o----
----------------D*-----------D###############-###-----oD-----D------------D---------------------DD--------D---------------D---------D-----------------
--------!--!----DD----------DD--------------#-----#--y-------D------------D-----------#---------DD--------D---------------D---------D-----------------
----------------D---------D--D#---y-----y---#-----#####------D------------D-----------#---------DD--------D---------------D---------D---------#-------
---M---------k---------------D###############----------------D------------D-----------#---------DD--------D----------D----D---------D-------g##-------
XXXXXXXXXXXXXX-----k----k----D--------------#---------#g-g---D------------D--------------#------DD--------D---------------D---------D-------###-------
XXXXXXXXXXXXXX--XXXXXXXXXXXXXX#---y-----y---#---------######-D------------D--------------#-XX---DD----XX--DDDDDDDDDDDD----DDDDDDDDDDD-----g####-------
----------------XXXXXXXXXXXXXX###############----------------DDDDDDDDDDDDD---------------#-XX---DD----XX-----------D---X------------------#####-------
------------------------------------------------------------------oo--------------oo----##-D----------D---o--------D---X----------------g######-------
------------------------------------------------------------------------------#---##---###-D---------*D---*----------o-X------ooo---oo--#######----F--
-------------------------------------------------------------k--y----y-----X--#--y--y--###-D*--oooo--D----D----r-----*-X-------y--Y--y-########----#--
------------------------------------------------------------XXXXXXXXXXXXXXXXXXXXXXXXXXXXXX--DDDDDDDDD----XXXXXXXXXXXXXXXXXXXXXXXXXXXXXXXXXXXXXXXXXXXXX
------------------------------------------------------------XXXXXXXXXXXXXXXXXXXXXXXXXXXXXX---------------XXXXXXXXXXXXXXXXXXXXXXXXXXXXXXXXXXXXXXXXXXXXX
