-------------------------------D------------D----------------------------------------D-----D------------DDD---------------D---------D-----------------
-------------------------------D------------D----------------------------------------D-----D------------D-D---------------D---------D-----------------
-------------------------------D------------D---------------------------YYY----------D-----D------------D-D---------------D---------D-----------------
-------------------------------D------------D---------------------------DDD---#-----oD-----D------------D-D---------------D---------D-----------o-----
-------------------------------D------------D-----------------------------D-###-----oD-----D------------D-D---------------D---------D----------o------
-------------------------------D------------D-----------------------------D-----#--y-------D------------D-D---------------D---------D---------o-------
-------------------------------D------------D--------------D------------D-D-----#####------D------------D-D---------------D---------D---------#-------
-------------------------------D------------D-------------YD------------o-D----------------D------------D-D----------D----D---------D--------##-------
X------o--o--------------------D------------D-------------DD----ooo-----o-D---------#g-g---D------------D-D---------------D---------D--------##-------
X------o--o--------------------D------------D--------------D-DD-DDDD-DDDDDD---------######-D------------D-DDDDDDDDDDDD----DDDDDDDDDDD-----o--##-------
X------------------------------DDDDDDDDDDDDD---------g-g-g-D-------------------------------DDDDDDDDDDDDD-----------D---X------------------#--##-------
X------!--!-------------------------oo-----------DDDDDDDDDDD------------------------------------oo--------o--------D---X-----------------##--##-------
X---------------D-----*-----D-------------------D----------D----------------------------------------------*----------o-X------ooo---oo---##--##----F--
X--M--------g-g-D-----D-----D--k--y----y-------D-----------D-------------------------------k--y----y------D----r-----*-X-------y--Y--y-#-##--##----#--
XXXXXXXXXXXXXXXXXXXXXXXXXXXXXXXXXXXXXXXXXXXXXXXXXXXXXXXXXXXX------------------------------XXXXXXXXXXXXXXXXXXXXXXXXXXXXXXXXXXXXXXXXXXXXXX-XX--XXXXXXXXX
XXXXXXXXXXXXXXXXXXXXXXXXXXXXXXXXXXXXXXXXXXXXXXXXXXXXXXXXXXXX------------------------------XXXXXXXXXXXXXXXXXXXXXXXXXXXXXXXXXXXXXXXXXXXXXX-XX--XXXXXXXXX
