----------------------------------------------D------------D-------------------------D---------------------------------------D----D-------------------
----------------------------------------------D------------D-------------------------D---------------------------------------D----D-------------------
--------!--!--------------------------------#-D------------D--------------#----------D---------------------------------------D----D-------------------
--------------------------------------------#-D------------D--------------#---#-----oD---------------------------------------D----D-----------o--o----
----------------------------------------------D------------D----------------###-----oD---------------------------------------Do--oD-------------------
--------!--!-----------------------------#----D------------D-----------#--------#--y-----------------------------------------Do--oD-------------------
-----------------------------------------#----D------------D-----------#--------#####---------------------------------------------------------#-------
---M---------k---------------------------#----D------------D-----------#--------------------------------D-------------o---------------------g##-------
XXXXXXXXXXXXXX------------------------------#-D------------D--------------#---------#g-g------------------X-----------2X---#y-#--#y-#-------###-------
XXXXXXXXXXXXXX------------------------------#-D------------D--------------#---------######-------o----D---X------------X#--####--####-----g####-------
--------------------------------------------#-DDDDDDDDDDDDD---------------#----------------------o--------X-----------oX------------------#####-------
----------------------C-S-S-C--------oo----##------oo--------------oo----##----------------------o------D-X-----------2X----------------g######-------
---------------------------------#---##---###------------------#---##---###----------------------o------D-X------------X----------------#######----F--
----------------------ooo-----X--#--y--y--###-k--y----y-----X--#--y--y--###---------------D------r------D-X-r-----r----X---------------########----#--
---------------XXXX--XXXXX-XXXXXXXXXXXXXXXXXXXXXXXXXXXXXXXXXXXXXXXXXXXXXXXX---------------XXX----D----XXXXXXX--XX-XX-XXX---------------XXXXXXXXXXXXXXX
---------------XXXX--XXXXX-XXXXXXXXXXXXXXXXXXXXXXXXXXXXXXXXXXXXXXXXXXXXXXXX---------------XXX---------XXXXXXX--XX-XX-XXX---------------XXXXXXXXXXXXXXX
