------------------------------------------------------------------------------------------------------------------------------------------------------
------------------------------------------------------------------------------------------------------------------------------------------------------
--------!--!------------------------------------------------------------------------------------------------------------------------------------------
----------------------------------------------------------------------------------------------------------------------D-----------------------o--o----
--------------------------------------------------oo-------------------------------------g---------------------------DD-------------------------------
X-------!--!--------------------------------X------------oX---------------D------------DDD----------------o-------oo--D-------------------------------
X-------------------o-----------------------X------------oX--------------------------TTDD-----------------o-------TT--D-----------------------#-------
X--M---------------Xo----------------------XX------------XX--------------------------tt----------------o--o-------tt--D---------------------g##-------
XXXXXoXXoXXoXX-----Xo----------XXX--XXXXX-XXX-XXX----XX--XX-----------TT-------g-g---tt----X-----------2X-o--oo-------D---------------------###-------
XXXXXXXXXXXXXX--XXXXXTTXXXXXX--XXX--XXXXX-XXX-XXX----XX--XX-----------tt---XXXXXXXTTXXXXXX-X------------X-o--TT-------D---------o---------g####-------
XXXXXXXXXXXX----XXXXXttXXXXXX--------------oX---X---------X-------TToott---XXXXXXXttXXXXXX-X-----------oX-o--tt---oo--D---------o---------#####-------
XXXXXXXXX------------tt-------X------------oXX--X---------X-------ttoott----------tt-------X-----------2X-o-------TT--D---------o-------g######-------
XXXXXX---------------tt-------X------------oXX--X---------X-------ttoott----------tt-------X------------X---------tt--D---------o-------#######----F--
XXX------------------tt---------------g----oX---X---------X-------ttggtt----------tt-------X-r-----r----X-----g---tt--D---------o------########----#--
XX-------------------tt-------XXXX--XXXXX-XXXXXXX---------X-XXXXXXXXXXXXXXX-------tt------XXXX--XX-XX-XXXX---XX-X--XX-XXX-------X-----XXXXXXXXXXXXXXXX
X--------------------tt-------XXXX--XXXXX-XXXXXXX---------X-XXXXXXXXXXXXXXX-------tt------XXXX--XX-XX-XXXX---XX-X--XX-XXX-------X-----XXXXXXXXXXXXXXXX
