--------------------------------------------------U------------------------------------------------------DD-------------------------------------------
----------------------------------------------------------------------------------------------------------D-------------------------------------------
--------!--!--------------------------------------D-------------------------------------------------------D-------------------------------------------
----------------------------------------------------D-----------------------------------------------------D-------------------------------------o-----
--------------------------------------------------D-------------------------------------------------------D--------------D---------o-*D--------o------
--------!--!----------------------------------------D-----------------------------------------------------D--------------D---------D--D-------o-------
---------------------------------------------D----D--------------------------------------o----------------D--------------D------------D-------#-------
---M---------k------------------------------oD--g--g----------------------D--------------o----------------D----------D---D*----o------D------##-------
XXXXXXXXXXXXXX------------------------------DDDDDDDDD------------------------------------o----------------D--------------D-----D------D------##-------
XXXXXXXXXXXXXX------------------------------D--------D-------------o----D----------------D--------o-------DDDDDDDDDDDD---D---o-------*D---o--##-------
--------------------------------o---------------------D------------o---------o--------------------o----------------D---X-D---D--------D---#--##-------
----------------------C-S-S-C---o----------*----ooo----D-----------o------D--o----------*---------o-------o--------D---X-D*------o----D--##--##-------
--------------------------------o-------*--D----o-o-----D----------o------D--o-------*--D---------o-------*----------o-X-D-------D----D--##--##----F--
----------------------ooo-----------k---D--D----ooo------D--D------r------D-----g--g-D--D---------o-------D----r-----*-X-------r------D#-##--##----#--
---------------XXXX--XXXXX-XXXXXXXXXXXXXXXXXX-------------XXXXX----D----XXXXXXXXXXXXXXXXXXX-------X-----XXXXXXXXXXXXXXXXX---X--X--X---XX-XX--XXXXXXXXX
---------------XXXX--XXXXX-XXXXXXXXXXXXXXXXXX-------------XXXXX---------XXXXXXXXXXXXXXXXXXX-------X-----XXXXXXXXXXXXXXXXX---X--X--X---XX-XX--XXXXXXXXX
