------------------------------------------------------------------------------------------DDDDDDD------------------------D----------------------------
------------------------------------------------------------------------------------------------D------------------------D----------------------------
------------------------------------------------------------------------------------------------D------------------------D----------------------------
---M---X--gX-g----------------------------------------------------------------------------------D------------------------D--------------------o--o----
XXXXXXXXXXXXXX------------------------------------------------------------------oo--------------D------------------------D----------------------------
XXXXXXXXXXXXXX---------------X--------------------------------------------D------------oX--X--ooD------------------------D----------------------------
-------------X---------------X-----o---------------------------------------------------oX--X--ooD------------------------D------o-------------#-------
-------------X--------------XX----Xo---------------------------------------------------XX--X---o----------------------o--D-----o-o----------g##-------
----------------XXX--XXXXX-XXX----Xo----------------------------------TT----XXX----XX--XX--X---o--------o-X-----------2X-D----o-o-o---------###-------
----------------XXX--XXXXX-XXX-XXXXXTTXXXXXX--------------------------tt----XXX----XX--XX--X------------D-X------------X-DDDDDDDDDDDDD----g####-------
-D-D-DD--D-D-DD-------------oX-XXXXXttXXXXXX----------------------TToott------X---------X--X--------------X-----------oX------------------#####-------
-D-D-D-D-D-D-D-X------------oX------tt---------2122222222X--------ttoott---X--X---------X--X---------o----X-----------2X----------------g######-------
-DD--DD--D-D-DDX------------oX------tt-------------ooooooX--------ttoott---X--X---------X--X---------D----X------------X------TT--------#######----F--
-D-D-D-D--D---D--------g----oX------tt---------g--gooooooX--------ttggtt------X---------X--X--------------X-r-----r----X------tt-------########----#--
-D-D-D-D--D--DDXXXX--XXXXX-XXX------tt-------XXXXXXXXXXXXXXXXXXXXXXXXXXXXXXXXXX---------X--X---DD--------XXXX--XX-XX-XXX--TT--tt---TT--XXXXXXXXXXXXXXX
---------------XXXX--XXXXX-XXX------tt-------XXXXXXXXXXXXXXXXXXXXXXXXXXXXXXXXXX---------X--X-------------XXXX--XX-XX-XXXX-tt--tt---tt--XXXXXXXXXXXXXXX
