----------------------------------------------D------------D--------------------------------------------------D----D----------------------------------
----------------------------------------------D------------D--------------------------------------------------D----D----------------------------------
--------!--!----------------------------------D------------D--------------------------------------------------D----D----------------------------------
----------------------------------------------D------------D--------------------------------------------------D----D----------------------------o-----
----------------------------------------------D------------D--------------------------------------------------Do--oD---------------------------o------
--------!--!--------------------------------X-D------------D--------------------------------------------------Do--oD--------------------------o-------
--------------------------------------------X-D------------D-----------------------------D----------------------------------------------------#-------
---M---------k-----------------------------XX-D------------D----------------------------YD-------------o-------------------------------------##-------
XXXXXXXXXXXXXX-----oooo-----g--XXX--XXXXX-XXX-D------------D------o---------------------DD-X-----------2X---#y-#--#y-#-----------------------##-------
XXXXXXXXXXXXXX-##--####--#####-XXX--XXXXX-XXX-D------------D-----o-o---------------------D-X------------X#--####--####----------o---------o--##-------
----------------#-y#--#-y#-----------------oX-DDDDDDDDDDDDD-----o-o-o--------------g-g-g-D-X-----------oX-----------------------o---------#--##-------
-----------------##----##-----X------------oX------oo----------o-o-o-o---------DDDDDDDDDDD-X-----------2X-----------------------o--------##--##-------
------------------------------X------------oX---------------D-----|-------D---D----------D-X------------X-----------------------o--------##--##----F--
--------------------------------------g----oX-k--y----y-----X-k---|----k--X--D-----------D-X-r-----r----X-----------------------o------#-##--##----#--
------------------------------XXXX--XXXXX-XXXXXXXXXXXXXXXXXXXXXXXXXXXXXXXXXXXXXXXXXXXXXXXXXXXX--XX-XX-XXX---------------X-------X-----XX-XX--XXXXXXXXX
------------------------------XXXX--XXXXX-XXXXXXXXXXXXXXXXXXXXXXXXXXXXXXXXXXXXXXXXXXXXXXXXXXXX--XX-XX-XXX---------------X-------X-----XX-XX--XXXXXXXXX
