------------------------------------------------------------------------------------------DD--------------D-------------------------------------------
-------------------------------------------------------------------------------------------D--------------D-------------------------------------------
--------!--!-------------------------------------------------------------------------------D--------------D-------------------------------------------
-------------------------------------------------------------------------------------------D--------------D-----------------------------------o--o----
-------------------------------------------------------------------------------------------D--------------D-------------------------------------------
--------!--!--------------------------------D----------------------------------------------D--------------D-------------------------------------------
--------------------------------------------------o--------------------------------------o-D--------------D------o--------------------o-------#-------
---M---------k-----------------------------------Xo--------------------------------------o-D----------D---D-----o-o-------------------o-----g##-------
XXXXXXXXXXXXXX--------------------------TT-------Xo----------------D---------------------o-D--------------D----o-o-o------------------o-----###-------
XXXXXXXXXXXXXX--------------------------tt----XXXXXTTXXXXXX---SSS@SSSS---D---------------D-DDDDDDDDDDDD---DDDDDDDDDDDDD---------------D---g####-------
------------------------------------TToott----XXXXXttXXXXXX----------S---D---o----------------------D---X-----------------o---------------#####-------
------------------------------------ttoott---------tt-----------------SSSD---o----------*--o--------D---X-----------------o----------*--g######-------
----------------D-----*-----D-------ttoott---------tt---------oo-------ooD---o-------*--D--*----------o-X------TT---------o-------*--D--#######----F--
----------------D-----D-----D-------ttggtt---------tt---------oo--g----ooD------g--g-D--D--D----r-----*-X------tt------------g--g-D--D-########----#--
---------------XXXXXXXXXXXXXXXXXXXXXXXXXXXXXX------tt-------XXXXXXXXXXXXXXXXXXXXXXXXXXXXXXXXXXXXXXXXXXXXX--TT--tt---TT--XXXXXXXXXXXXXXXXXXXXXXXXXXXXXX
---------------XXXXXXXXXXXXXXXXXXXXXXXXXXXXXX------tt-------XXXXXXXXXXXXXXXXXXXXXXXXXXXXXXXXXXXXXXXXXXXXXX-tt--tt---tt--XXXXXXXXXXXXXXXXXXXXXXXXXXXXXX
