----------------------------------------------D------------D------------------------------DDDDDDD---------D-------------------------------------------
----------------------o-----------------------D------------D------------------------------------D---------D-------------------------------------------
----------------------------------------------D------------D--------------#---------------------D---------D-------------------------------------------
---M---X--gX-g----#---y---#-------------------D------------D--------------#---------------------D---------D-------------------------------------o-----
XXXXXXXXXXXXXX-###############----------------D------------D--------------------oo--------------D---------D------------------------------------o------
XXXXXXXXXXXXXX---------------#----------------D------------D-----------#---------------oX--X--ooD---------D-----------------------------------o-------
-------------X-#---y-----y---#----------------D------------D-----------#---------------oX--X--ooD---------D-----------------------------------#-------
-------------X-###############----------------D------------D-----------#---------------XX--X---o----------D----------------------------------##-------
-----------------------------#----------------D------------D--------------#-XXX----XX--XX--X---o--------o-DDDDDDDDDDD------------------------##-------
---------------#---y-----y---#----------------D------------D--------------#-XXX----XX--XX--X------------D-----------------------o---------o--##-------
-D-D-DD--D-D-DD###############----------------DDDDDDDDDDDDD---------------#---X---------X--X------------------------------------o---------#--##-------
-D-D-D-D-D-D-D-----------------------C-S-S-C-------oo--------------oo----##X--X---------X--X---------o--------o--------Y--------o--------##--##-------
-DD--DD--D-D-DD------------------------------------------------#---##---###X--X---------X--X---------D--------o--------Y--------o--------##--##----F--
-D-D-D-D--D---D----------------------ooo------k--y----y-----X--#--y--y--###---X---------X--X------------------o-----Dy-D--------o------#-##--##----#--
-D-D-D-D--D--DD---------------XXXX--XXXXX-XXXXXXXXXXXXXXXXXXXXXXXXXXXXXXXXXXXXX---------X--X---DD--------X----X-----XXXXX-------X-----XX-XX--XXXXXXXXX
------------------------------XXXX--XXXXX-XXXXXXXXXXXXXXXXXXXXXXXXXXXXXXXXXXXXX---------X--X-------------X----X-----XXXXX-------X-----XX-XX--XXXXXXXXX
