--------------------------------------------------------------------------------------------------------DDD-------------------------------------------
--------------------------------------------------------------------------------------------------------D-D-------------------------------------------
--------!--!--------------------------------------------------------------------------------------------D-D-------------------------------------------
--------------------------------------------------------------------------------------------------------D-D-----------------------------------o--o----
--------------------------------------------------------------------------------------------------------D-D-------------------------------------------
X-------!--!-------------------------------------------------------------------------------oo-----------D-D-------------------------------------------
X-------------------------------------------------------------------------o-----------------------------D-D-----------------------------------#-------
X--M-------------------------o--------------------------------------------o--------------D--------------D-D----------D----------------------g##-------
XXXXXoXXoXXoXX---------------D--------------------------------------------o----------------DD--oo---------D---------------------------------###-------
XXXXXXXXXXXXXX---------------D--------------------------------------------D-------o----D---D*-------------DDDDDDDDDDDD--------------------g####-------
XXXXXXXXXXXX-----o--------------------------------------------o-------------------o--------D*----------o-----------D---X-------o-----*D---#####-------
XXXXXXXXX--------o----------*--------C-S-S-C---2122222222X----o----------*--------o------D-D----g------o--o--------D---X-------o----ooD-g######-------
XXXXXX-----------o-------*--D----------------------ooooooX----o-------*--D--------o------D-D---DD------o--*----------o-Xo------o----DDD-#######----F--
XXX------------------k---D--D--------ooo-------g--gooooooX-------g--g-D--D-D------r------D-D*----------g--D----r-----*-Xo------g-----*D########----#--
XX-------------XXXXXXXXXXXXXXXXXXX--XXXXX-XXXXXXXXXXXXXXXXXXXXXXXXXXXXXXXXXXXX----D----XXX-D----------DD-XXXXXXXXXXXXXXXX------X-----XXXXXXXXXXXXXXXXX
X--------------XXXXXXXXXXXXXXXXXXX--XXXXX-XXXXXXXXXXXXXXXXXXXXXXXXXXXXXXXXXXXX---------XXX-D-------------XXXXXXXXXXXXXXXX------X-----XXXXXXXXXXXXXXXXX
