-----------------------------------------------------------------U----------D------------D-D----------------------------------------------------------
----------------------------------------------------------------------------D------------D-D----------------------------------------------------o-----
-----------------------------------------------------------------D----------D------------D-D----------------------------------------------------o-----
---M---X--gX-g-----------------------------------------------------D--------D------------D-D----------------------------------------------------D-----
XXXXXXXXXXXXXX---------------------------------------------------D----------D------------D-D---------------------------------------------------D------
XXXXXXXXXXXXXX-----------------------------------------------------D--------D------------D-D--------------------------------------------------D-------
-------------X---------------------------------------------DD----D----------D------------D-D------o-----------------------------------D---------------
-------------X--------------------------------------------YDD--g--g---------D------------D-D-----o-o---------------------------------YD-DDDD----------
----------------------------------oooo-----g--------------DDDDDDDDDD--------D------------D-D----o-o-o--------------------------------DD---------D-----
-----------------------------X##--####--#####--------------D--------D-------D------------D-DDDDDDDDDDDDD------------------------------DD--------D-----
-D-D-DD--D-D-DD------TT-----XX-#-y#--#-y#------------g-g-g-D---------D------DDDDDDDDDDDDD---------------------------------------g-g-g-D---------D-----
-D-D-D-D-D-D-D------otto-----X--##----##---------DDDDDDDDDDD---ooo----D----------oo-----------------------------------------DDDDDDDDDDD---------------
-DD--DD--D-D-DD-----otto-----X------------------D----------D---o-o-----D------------------------TT-------------------------D----------D------------F--
-D-D-D-D--D---DX-X--otto--X-X------------------D-----------D---ooo------D---k--y----y-----------tt------------------------D-----------D------------#--
-D-D-D-D--D--DDXXXXXXXXXXXXXXX---------------XXXXXXXXXXXXXXX-------------XXXXXXXXXXXXXXXXX--TT--tt---TT------D--y---D---XXXXXXXXXXXXXXXXXXXXXXXXXXXXXX
---------------XXXXXXXXXXXXXXX---------------XXXXXXXXXXXXXXX-------------XXXXXXXXXXXXXXXXXX-tt--tt---tt--XX---TTXXTT--XXXXXXXXXXXXXXXXXXXXXXXXXXXXXXXX
