-------------------------------------------------------------------D----------------------DD-------------------DD-------------------------------------
-------------------------------------------------------------------D-----------------------D-------------------DD-------------------------------------
-------------------------------------------------------------------D-----------------------D-------------------DD-------------------------------------
-------------------------------------------------------------------D-----------------------D-------------------DD-------------------------------------
--------------------------------------------------oo---------------D-----------------------D-------------------DD-------------------------------------
---------------------------------------------------------oX--XXXX--D-----------------------D-------------------DD-----------------------------o-------
o--------------------------------------------------------oX--XXXX--Dg-g--------------------D-------------------DD-----------------------------#-------
X-------------------------------------------o------------XX--DX-----DDDDD----------------D-D----------D--------DD----------------------------##-------
X-------------------------------------------D-XXX----XX--XX--D*----------------------------D-------------------DD--------------------------o-##-------
X--------o----------------------------------D-XXX----XX--XX--DX-------------------o----D---DDDDDDDDDDDD---XX---DD----XX---------o----------#-##-------
X--------o----------------------o---------------X---------X--DX*---------D--------o-----------------D---X-XX---DD----XX---------o---------##-##-------
X--------o------------C-S-S-C---o----------*-X--X---------X--DX------ooooD--------o------D-o--------D---X-D----------D----------o--------###-##-------
XX------------------------------o-------*--D-X--X---------X--D*------ooooD--------o------D-*----------o-X-D---------*D----------o------o-###-##----F--
XX-M-D--gD-gD-g-------ooo-----------k---D--D----X---------X-DDDDDDDDDDDDDDDD------r------D-D----r-----*-X-D*--oooo--D-----------o------#-###-##g--g#--
XXXXXXXXXXXXXXXXXXX--XXXXX-XXXXXXXXXXXXXXXXXXXXXX---------X----------------XXX----D----XXXXXXXXXXXXXXXXXX--DDDDDDDDD----X-------X-----XX-XXX-XXXXXXXXX
XXXXXXXXXXXXXXXXXXX--XXXXX-XXXXXXXXXXXXXXXXXXXXXX---------X----------------XXX---------XXXXXXXXXXXXXXXXXX---------------X-------X-----XX-XXX-XXXXXXXXX
