-------------------------------------------------------------------------------------------D------------D-----------------------------D---------------
-------------------------------------------------------------------------------------------D------------D-----------------------------D---------------
--------!--!-------------------------------------------------------------------------------D------------D-----------------------------D---------------
-------------------------------------------------------------------------------------------D------------D-----------------------------D---------o-----
-----------------------------------------------------------------oo------------------------D------------D-----------------------------D--------o------
--------!--!------------------------------------------------------------oX-----------------D------------D----------------oo-----------D-------o-------
------------------------------------------------------------------------oX-----------------D*-----------D-----------------------------D-------#-------
---M---------k---------------------------------------------D------------XX---------------o--------------D--------------o--------------D------##-------
XXXXXXXXXXXXXX-----------------------------------------------XXX----XX--XX---------------D-X*-----------D--------------D-DD--oo--------------##-------
XXXXXXXXXXXXXX--------------------------------------o----D---XXX----XX--XX---------------D-XX*------k---D--------------D-D*---------------o--##-------
----------------------------------------------------o----------X---------X---o-------------XXXXXXXXXXXXo---o-------------D*----------o----#--##-------
----------------------C-S-S-C-----------------------o------DX--X---------X---o----------*-------------Xo---o----------*--D----g------o---##--##-------
-------------------------------D-----*-----D--------o------DX--X---------X---o-------*--D-------------Xo---o-------*--D--D---DD------o---##--##----F--
----------------------ooo------D-----D-----D-D------r------D---X---------X-------k---D--D-------------Xo-------k---D--D--D*----------g-#-##--##----#--
---------------XXXX--XXXXX-XXXXXXXXXXXXXXXXXXXXX----D----XXXXXXX---------X-XXXXXXXXXXXXXXX------------XXXXXXXXXXXXXXXXXX-D----------DD-X-XX--XXXXXXXXX
---------------XXXX--XXXXX-XXXXXXXXXXXXXXXXXXXXX---------XXXXXXX---------X-XXXXXXXXXXXXXXX------------XXXXXXXXXXXXXXXXXX-D-------------X-XX--XXXXXXXXX
