------------------------------------------------------D-----------------------------------------------------------------------------------------------
------------------------------------------------------D-----------------------------------------------------------------------------------------------
------------------------------------------------------D-----------------------------------------------------------------------------------------------
----------------------------------------------DDTT------k-k-----------------------------------------------------------------------------------o--o----
----------------------------------------------DDtt--TT-DDDDD------------------------------------------------------------------------------------------
--------------------------------------------X---tt--tt------------------------------------------------------------------------------------------------
--------------------------------------------X---tt--tt----------------------------------------------------------------------------------------#-------
-------------------------------------------XX---tt--tt-----------------------------------------------------------------D-------------o------g##-------
X------o--o--------------------XXX--XXXXX-XXX---tt--tt---------------------------o---------------------------------------X-----------2X-----###-------
X------o--o------------------X-XXX--XXXXX-XXX---tt--tt--------------------------o-o---------------o-------------o----D---X------------X---g####-------
X--------------------TT-----XX-------------oX---tt--tt-------------------------o-o-o--------------o-------------o--------X-----------oX---#####-------
X------!--!---------otto-----XX------------oX---tt--tt--------2122222222X-----o-o-o-o-------------o-------------o------D-X-----------2X-g######-------
X-------------------otto-----XX------------oX---tt--tt------------ooooooX--D-----|-------D--------o-------------o------D-X------------X-#######----F--
X--M--------g-gX-X--otto--X-X---------g----oX---tt--tt--------g--gooooooX--X-k---|----k--X--------o------D------r------D-X-r-----r----X########----#--
XXXXXXXXXXXXXXXXXXXXXXXXXXXXXXXXXX--XXXXX-XXX---tt--tt------XXXXXXXXXXXXXXXXXXXXXXXXXXXXXXX-------X-----XXXX----D----XXXXXXX--XX-XX-XXXXXXXXXXXXXXXXXX
XXXXXXXXXXXXXXXXXXXXXXXXXXXXXXXXXX--XXXXX-XXX---tt--tt------XXXXXXXXXXXXXXXXXXXXXXXXXXXXXXX-------X-----XXXX---------XXXXXXX--XX-XX-XXXXXXXXXXXXXXXXXX
