-------------------------------------------------------D-----------------------------------D----------------------------------------------------------
-------------------------------------o-----------------D-----------------------------------D----------------------------------------------------------
-------------------------------------------------------D------------------#----------------D----------------------------------------------------------
---M---X--gX-g-------------------#---y---#------#-----oD------------------#------------G---D----------------------------------------------------------
XXXXXXXXXXXXXX----------------###############-###-----oD--------------------DDD--------DD--D----------------------------------------------------------
XXXXXXXXXXXXXX---------------X--------------#-----#--y-----------------#----DDD--------DD--D--------------------------------------------------o-------
-------------X---------------X#---y-----y---#-----#####----------------#------D--------D---D--------------------------------------------------#-------
-------------X--------------XX###############--------------------------#---D---Dg----gD--D-D------------------------------------------D------##-------
----------------XXX--XXXXX-XXX--------------#---------#g-g----------------#-----D----D-----DDDDDDDDDDD-------------------------------------o-##-------
----------------XXX--XXXXX-XXX#---y-----y---#---------######--------------#------DooD----------------------------o-------------o----D------#-##-------
-D-D-DD--D-D-DD-------------oX###############-----------------------------#------DooD----------------------------o-------------o----------##-##-------
-D-D-D-D-D-D-D-X------------oX-------------------------------------oo----##------DooD----------o--------Y--------o-------------o------D--###-##-------
-DD--DD--D-D-DDX------------oX---------------------------------#---##---###-------DD-----------o--------Y--------o-------------o------Do-###-##----F--
-D-D-D-D--D---D--------g----oX------------------------------X--#--y--y--###--------------------o-----Dy-D--------o------D------r------D#-###-##g--g#--
-D-D-D-D--D--DDXXXX--XXXXX-XXX------------------------------XXXXXXXXXXXXXXX---------------X----X-----XXXXX-------X-----XXXX----D----XXXX-XXX-XXXXXXXXX
---------------XXXX--XXXXX-XXX------------------------------XXXXXXXXXXXXXXX---------------X----X-----XXXXX-------X-----XXXX---------XXXX-XXX-XXXXXXXXX
