--------------------------------------------------------------------------------------------D---------D-----------------------------------------------
--------------------------------------------------------------------------------------------D---------D-----------------------------------------------
--------------------------------------------#-----------o-----------------------------------D---------D----------------#------------YYY---------------
--------------------------------------------#-----G--G-D-D----------------------------------D---------D----------------#------------DDD---------------
----------------------------------------------DDDDDDDDDDoD----------------------------------D---------D-------------------------------D---------------
-----------------------------------------#----DDDDDDDDDD-D----------------------------------D---------D-------------#-----------------D-------o-------
-----------------------------------------#-------------DoD-------------------------------D--D---------D-------------#---------------D-D-------#-------
-----------------------------------------#---D---------D-D----------------o-------------YD--D---------D-------------#---------------o-D------##-------
X------o--o---------------------------------#----------DoD----------------D-------------DD--D---------D----------------#----ooo-----o-D----o-##-------
X------o--o---------------------------------#----------D-D----------------D--------------D--DDDDDDDDDDD----------------#-DD-DDDD-DDDDDD----#-##-------
X-------------------------------------------#----------DoD----o--------------------g-g-g-D-----------------------------#------------------##-##-------
X------!--!--------------------------oo----##----------D-D----o----------*-----DDDDDDDDDDD----------------------oo----##-----------------###-##-------
X---------------D-----*-----D----#---##---###----------Do-----o-------*--D----D----------D------ooo---oo----#---##---###---------------o-###-##----F--
X--M--------g-g-D-----D-----D-X--#--y--y--###----------D----------k---D--D---D-----------D-------y--Y--y-X--#--y--y--###---------------#-###-##g--g#--
XXXXXXXXXXXXXXXXXXXXXXXXXXXXXXXXXXXXXXXXXXXXX----------XXXXXXXXXXXXXXXXXXXXXXXXXXXXXXXXXXXXXXXXXXXXXXXXXXXXXXXXXXXXXXXXX---------------X-XXX-XXXXXXXXX
XXXXXXXXXXXXXXXXXXXXXXXXXXXXXXXXXXXXXXXXXXXXX----------XXXXXXXXXXXXXXXXXXXXXXXXXXXXXXXXXXXXXXXXXXXXXXXXXXXXXXXXXXXXXXXXX---------------X-XXX-XXXXXXXXX
