----------------D------------D---------------------------------------D--------------------------------------------------------------------------------
----------------D------------D---------------------------------------D--------------------------------------------------------------------------------
----------------D------------D---------------------------------------D--------------------------------------------------------------------------------
----------------D------------D-------------------------------DDTT------k-k----------------------------------------------------------------------o-----
----------------D------------D-----------------------------g-DDtt--TT-DDDDD----------------------------YD--------------------------------------o------
----------------D------------D---------------------------DDD---tt--tt--------------------D------------TTD-------------------------------------o-------
o---------------D------------D-------------------------TTDD----tt--tt-----------------------------TT--ttD-------------------------------------#-------
X---------------D------------D-------------------------tt------tt--tt---------------------------y-tty-ttD------------------------------------##-------
X---------------D------------D-------------------g-g---tt------tt--tt----------------TT----DDTTDDDttDDttD------------------------------------##-------
X--------o------D------------D--------------XXXXXXXXTTXXXXXX---tt--tt----------------tt------tt---tt--tt----------------------------------o--##-------
X--------o------DDDDDDDDDDDDD-------TT-----XXXXXXXXXttXXXXXX---tt--tt------------TToott------tt---tt--tt----------------------------------#--##-------
X--------o-----------oo------------otto-----X-------tt---------tt--tt------------ttoott------tt---tt--tt---------------------------------##--##-------
XX---------------------------------otto-----X-------tt---------tt--tt------------ttoott------tt---tt--tt---------------------------------##--##----F--
XX-M-D--gD-gD-g-k--y----y-----X-X--otto--X-X--------tt---------tt--tt------------ttggtt------tt---tt--tt-------------------------------#-##--##----#--
XXXXXXXXXXXXXXXXXXXXXXXXXXXXXXXXXXXXXXXXXXXXX-------tt---------tt--tt------XXXXXXXXXXXXXXX---tt---tt--tt-----D--y---D-------D--y---D---X-XX--XXXXXXXXX
XXXXXXXXXXXXXXXXXXXXXXXXXXXXXXXXXXXXXXXXXXXXX-------tt---------tt--tt------XXXXXXXXXXXXXXX---tt---tt--tt-XX---TTXXTT--XXXX---TTXXTT--XXX-XX--XXXXXXXXX
