------------------------------------------------------------------------------------------------DD--------D------------DDD----------------------------
------------------------------------------------------------------------------------------------DD--------D------------D-D----------------------------
--------!--!------------------------------------------------------------------------------------DD--------D------------D-D----------------------------
------------------------------------------------------------------------------------------------DD--------D------------D-D----------------------------
-----------------------------------------------------------------oo-----------------------------DD--------D------------D-D----------------------------
--------!--!------------------------------------------------------------oX----------------------DD--------D------------D-D--------------------o-------
-----------------------------------------------------------o------------oX----------------------DD--------D*-----------D-D--------------------#-------
---M---------k--------------o------------------------------o------------XX---------------o------DD---------------------D-D----------D--------##-------
XXXXXXXXXXXXXX--X-----------2X-----------------------------o-XXX----XX--XX---------------D------DD--------X*-----------D-D-----------------o-##-------
XXXXXXXXXXXXXX--X------------X-----------------------------D-XXX----XX--XX---------------D-XX---DD----XX--XX*------k---D-DDDDDDDDDDDD------#-##-------
----------------X-----------oX-----------------o---------------X---------X---o-------------XX---DD----XX--XXXXXXXXXXXXo-----------D---X---##-##-------
----------------X-----------2X-----------------o----------*-X--X---------X---o----------*--D----------D--------------Xo--o--------D---X--###-##-------
----------------X------------X-D-----*-----D---o-------*--D-X--X---------X---o-------*--D--D---------*D--------------Xo--*----------o-Xo-###-##----F--
----------------X-r-----r----X-D-----D-----D------g--g-D--D----X---------X-------k---D--D--D*--oooo--D---------------Xo--D----r-----*-X#-###-##g--g#--
---------------XXXX--XX-XX-XXXXXXXXXXXXXXXXXXXXXXXXXXXXXXXXXXXXX---------X-XXXXXXXXXXXXXXX--DDDDDDDDD----------------XXXXXXXXXXXXXXXXXXX-XXX-XXXXXXXXX
---------------XXXX--XX-XX-XXXXXXXXXXXXXXXXXXXXXXXXXXXXXXXXXXXXX---------X-XXXXXXXXXXXXXXX---------------------------XXXXXXXXXXXXXXXXXXX-XXX-XXXXXXXXX
