-------------------------------------------------------------D------------D----------------D-------------DD--------------D----------------------------
-------------------------------------------------------------D------------D----------------D--------------D--------------D----------------------------
-----------------------------#-------------------------------D------------D----------------D--------------D--------------D----------------------------
-----------------------------#-------------------------------D------------D----------------D--------------D--------------D--------------------o--o----
-------------------------------------------------------------D------------D----------------D--------------D--------------D----------------------------
--------------------------#----------------------------------D------------D----------------D-----o--------D--------------D----------------------------
--------------------------#--------------------------------o-D------------D--------------D-D----o-o-------D--------------D--------------------#-------
--------------------------#--------------------------------o-D------------D-------------YD-D---o-o-o--D---D----------D---D------------------g##-------
X------o--o------------------#-----------------------------o-D------------D-------------DD-DDDDDDDDDDDDo--D--------------DDDDDDDDDDDDDD-----###-------
X------o--o------------------#-----------------------------D-D------------D--------------D-------------oD-DDDDDDDDDDDD---------------D----g####-------
X----------------------------#-----------------o-------------DDDDDDDDDDDDD---------g-g-g-DX------------oD----------D---X-------------*----#####-------
X------!--!-----------oo----##-----------------o----------*-------oo-----------DDDDDDDDDDDX*-----------DD-o--------D---X----------------g######-------
X-----------------#---##---###-D-----*-----D---o-------*--D-------------------D----------DX*------------X-*----------o-XXoooooooooooo*X-#######----F--
X--M--------g-gX--#--y--y--###-D-----D-----D------g--g-D--D--k--y----y-------D-----------DX---y-----y---X-D----r-----*-XX---y--y--y---X########----#--
XXXXXXXXXXXXXXXXXXXXXXXXXXXXXXXXXXXXXXXXXXXXXXXXXXXXXXXXXXXXXXXXXXXXXXXXXXXXXXXXXXXXXXXXXXXXXXXXXXXXXXXXXXXXXXXXXXXXXXXXXXXXXXXXXXXXXXXXXXXXXXXXXXXXXX
XXXXXXXXXXXXXXXXXXXXXXXXXXXXXXXXXXXXXXXXXXXXXXXXXXXXXXXXXXXXXXXXXXXXXXXXXXXXXXXXXXXXXXXXXXXXXXXXXXXXXXXXXXXXXXXXXXXXXXXXXXXXXXXXXXXXXXXXXXXXXXXXXXXXXX
