------------------------------------------------------------------------------------------DD--------------D------------D-D----------------------------
-------------------------------------------------------------------------------------------D--------------D------------D-D----------------------------
--------!--!-------------------------------------------------------------------------------D--------------D------------D-D----------------------------
-------------------------------------------------------------------------------------------D--------------D------------D-D----------------------------
-------------------------------------------------------------------------------------------D--------------D------------D-D----------------------------
X-------!--!--------------------------------------------------------------D----------------D--------------D------------D-D--------------------o-------
X-------------------o-----------------------------------------------------------o----------D--------------D------------D-D------o-------------#-------
X--M---------------Xo--------------------------------------o-------------------Xo----------D----------D---D------------D-D-----o-o-----------##-------
XXXXXoXXoXXoXX-----Xo--------------------------------------D----------TT-------Xo----------D--------------D------------D-D----o-o-o--------o-##-------
XXXXXXXXXXXXXX--XXXXXTTXXXXXX------------------------------D----------tt----XXXXXTTXXXXXX--DDDDDDDDDDDD---D----oo-----oD-DDDDDDDDDDDDD-----#-##-------
XXXXXXXXXXXX----XXXXXttXXXXXX------------------o------------------TToott----XXXXXttXXXXXX-----------D---X-D-----------*D------------------##-##-------
XXXXXXXXX------------tt------------------------o----------*-------ttoott---------tt--------o--------D---X-Do---TT------------------------###-##-------
XXXXXX---------------tt--------D-----*-----D---o-------*--D-------ttoott---------tt--------*----------o-X-D*---tt--oo---------TT-------o-###-##----F--
XXX------------------tt--------D-----D-----D-------k---D--D-------ttggtt---------tt--------D----r-----*-X------tt-------------tt-------#-###-##g--g#--
XX-------------------tt-------XXXXXXXXXXXXXXXXXXXXXXXXXXXXXXXXXXXXXXXXXXXXX------tt-------XXXXXXXXXXXXXXXXXXX--tt--TT-XX--TT--tt---TT--X-XXX-XXXXXXXXX
X--------------------tt-------XXXXXXXXXXXXXXXXXXXXXXXXXXXXXXXXXXXXXXXXXXXXX------tt-------XXXXXXXXXXXXXXXX-----tt--tt---X-tt--tt---tt--X-XXX-XXXXXXXXX
