----------------------------------------------D------------D-D--------------------------------------------D------------D-D----------------------------
----------------------------------------------D------------D-D--------------------------------------------D------------D-D----------------------------
--------!--!--------------------------------#-D------------D-D--------------------------------------------D------------D-D----------------------------
--------------------------------------------#-D------------D-D--------------------------------------------D------------D-D----------------------------
----------------------------------------------D------------D-D-----------------------------------------YD-D------------D-D----------------------------
X-------!--!-----------------------------#----D------------D-D----------------------------------------TTD-D------------D-D--------------------o-------
X----------------------------------------#----D------------D-D------o--------------------D--------TT--ttD-D------------D-D------o-------------#-------
X--M-------------------------------------#----D------------D-D-----o-o------------------YD------y-tty-ttD-D------------D-D-----o-o-----------##-------
XXXXXoXXoXXoXX------------------------------#-D------------D-D----o-o-o-----------------DD-DDTTDDDttDDttD-D------------D-D----o-o-o--------o-##-------
XXXXXXXXXXXXXX---------------X--------------#-D------------D-DDDDDDDDDDDDD---------------D---tt---tt--tt--D------------D-DDDDDDDDDDDDD-----#-##-------
XXXXXXXXXXXX---------TT-----XX--------------#-DDDDDDDDDDDDD------------------------g-g-g-D---tt---tt--tt--DDDDDDDDDDDDD-------------------##-##-------
XXXXXXXXX-----------otto-----X-------oo----##------oo--------------------------DDDDDDDDDDD---tt---tt--tt-------oo------------------------###-##-------
XXXXXX--------------otto-----X---#---##---###---------------------TT----------D----------D---tt---tt--tt----------------------TT-------o-###-##----F--
XXX------------X-X--otto--X-X-X--#--y--y--###-k--y----y-----------tt---------D-----------D---tt---tt--tt--k--y----y-----------tt-------#-###-##g--g#--
XX-------------XXXXXXXXXXXXXXXXXXXXXXXXXXXXXXXXXXXXXXXXXXXXX--TT--tt---TT--XXXXXXXXXXXXXXX---tt---tt--tt-XXXXXXXXXXXXXXX--TT--tt---TT--X-XXX-XXXXXXXXX
X--------------XXXXXXXXXXXXXXXXXXXXXXXXXXXXXXXXXXXXXXXXXXXXXX-tt--tt---tt--XXXXXXXXXXXXXXX---tt---tt--tt-XXXXXXXXXXXXXXXX-tt--tt---tt--X-XXX-XXXXXXXXX
