-------------------------------------------------------D-----------------------------------D------------D---------------------------------------------
-------------------------------------------------------D-----------------------------------D------------D---------------------------------------------
--------!--!--------------------------------#----------D-----------------------------------D------------D---------------------------------------------
--------------------------------------------#---#-----oD-----------------------------------D------------D-------------------------------------o--o----
----------------------------------------------###-----oD-----------------------------------D------------D---------------------------------------------
X-------!--!-----------------------------#--------#--y-------------------------------------D------------D---------------------------------------------
X-------------------o--------------------#--------#####------------------------------------D------------D-------------------------------------#-------
X--M---------------Xo--------------------#-------------------------------------------------D------------D-----------------------------------g##-------
XXXXXoXXoXXoXX-----Xo-----------------------#---------#g-g--------o---------------D--------D------------D-----------------------------------###-------
XXXXXXXXXXXXXX--XXXXXTTXXXXXX---------------#---------######-----o-o---------SSS@SSSS---D--D------------D---------------------------------g####-------
XXXXXXXXXXXX----XXXXXttXXXXXX---------------#-------------------o-o-o---------------S---D--DDDDDDDDDDDDD----------------------------------#####-------
XXXXXXXXX------------tt--------------oo----##---------------K--o-o-o-o--K------------SSSD-------oo--------------------------------------g######-------
XXXXXX---------------tt----------#---##---###---------------D---D---D---D----oo-------ooD-----------------------------------------------#######----F--
XXX------------------tt-------X--#--y--y--###-----------------D---D---D------oo--g----ooD--k--y----y-----------------------------------########----#--
XX-------------------tt-------XXXXXXXXXXXXXXX---------------XXXXXXXXXXXXXXXXXXXXXXXXXXXXXXXXXXXXXXXXXXXXX----D--y---D-------D--y---D---XXXXXXXXXXXXXXX
X--------------------tt-------XXXXXXXXXXXXXXX---------------XXXXXXXXXXXXXXXXXXXXXXXXXXXXXXXXXXXXXXXXXXXXXXX---TTXXTT--XXXX---TTXXTT--XXXXXXXXXXXXXXXXX
