----------------------------------------------D------------D------------------------------------------------------------------------------------------
----------------------------------------------D------------D------------------------------------------------------------------------------------------
----------------------------------------------D------------D------------------------------------------YYY---------------------------------------------
----------------------------------------------D------------D------------------------------------------DDD---------------------------------------------
----------------------------------------------D------------D-----------------------------g--------------D---------------------------------------------
----------------------------------------------D------------D--------------D------------DDD--------------D-------------------------------------o-------
-----------------------------D-----o----------D------------D-------------------------TTDD-------------D-D-----------------------------D-------#-------
----------------------------YD----Xo----------D------------D-------------------------tt---------------o-D-D----y---y---Y-------------YD------##-------
X------o--o-----------------DD----Xo----------D------------D----------TT-------g-g---tt-------ooo-----o-D-DDTTDDDTTDDTTD-------------DD----o-##-------
X------o--o------------------D-XXXXXTTXXXXXX--D------------D----------tt---XXXXXXXTTXXXXXX-DD-DDDD-DDDDDD---tt---tt--tt---------------D----#-##-------
X----------------------g-g-g-D-XXXXXttXXXXXX--DDDDDDDDDDDDD-------TToott---XXXXXXXttXXXXXX------------------tt---tt--tt---------g-g-g-D---##-##-------
X------!--!--------DDDDDDDDDDD------tt-------------oo-------------ttoott----------tt------------------------tt---tt--tt-----DDDDDDDDDDD--###-##-------
X-----------------D----------D------tt----------------------------ttoott----------tt------------------------tt---tt--tt----D----------Do-###-##----F--
X--M--------g-g--D-----------D------tt--------k--y----y-----------ttggtt----------tt------------------------tt---tt--tt---D-----------D#-###-##g--g#--
XXXXXXXXXXXXXXXXXXXXXXXXXXXXXX------tt-------XXXXXXXXXXXXXXXXXXXXXXXXXXXXXX-------tt------------------------tt---tt--tt-XXXXXXXXXXXXXXXX-XXX-XXXXXXXXX
XXXXXXXXXXXXXXXXXXXXXXXXXXXXXX------tt-------XXXXXXXXXXXXXXXXXXXXXXXXXXXXXX-------tt------------------------tt---tt--tt-XXXXXXXXXXXXXXXX-XXX-XXXXXXXXX
