------------------------------------------------------------------------------------------------------------------------------------------------------
------------------------------------------------------------------------------------------------------------------------------------------------------
------------------------------------------------------------------------------------------------------------------------------------------------------
------------------------------------------------------------------------G---------------------------------------------------------------------o--o----
--------------------------------------------------oo---------DDD--------DD----------------------------------------------------------------------------
---------------------------------------------------------oX--DDD--------DD----------------------------------------------------------------------------
o--------------------------------------------------------oX----D--------D---------------------------------------------------------------------#-------
X--------------------------------------------------------XX-D---Dg----gD--D--------------D-------------o------------------------------------g##-------
X---------------------------------------------XXX----XX--XX------D----D--------------------X-----------2X-----------------------------------###-------
X--------o----------------------------------X-XXX----XX--XX-------DooD------------o----D---X------------X-----------------------o---------g####-------
X--------o--------------------------TT-----XX---X---------X-------DooD------------o--------X-----------oX-----------------------o---------#####-------
X--------o------------C-S-S-C------otto-----XX--X---------X-------DooD------------o------D-X-----------2X-------C-S-S-C---------o-------g######-------
XX---------------------------------otto-----XX--X---------X--------DD-------------o------D-X------------X-----------------------o-------#######----F--
XX-M-D--gD-gD-g-------ooo-----X-X--otto--X-X----X---------X----------------D------r------D-X-r-----r----X-------ooo-------------o------########----#--
XXXXXXXXXXXXXXXXXXX--XXXXX-XXXXXXXXXXXXXXXXXXXXXX---------X----------------XXX----D----XXXXXXX--XX-XX-XXXXXXX--XXXXX-XXXX-------X-----XXXXXXXXXXXXXXXX
XXXXXXXXXXXXXXXXXXX--XXXXX-XXXXXXXXXXXXXXXXXXXXXX---------X----------------XXX---------XXXXXXX--XX-XX-XXXXXXX--XXXXX-XXXX-------X-----XXXXXXXXXXXXXXXX
