----------------D-----------------------------D------------D--------------------------------D---------D-----------------------DD----------------------
----------------D-----------------------------D------------D--------------------------------D---------D-----------------------DD----------------------
--------!--!----D---------------------------#-D------------D---------------------------YYY--D---------D-----------------------DD----------------------
----------------D------------D--------------#-D------------D---------------------------DDD--D---------D-----------------------DD--------------o--o----
----------------D*-----------D----------------D------------D-----------------------------D--D---------D-----------------------DD----------------------
--------!--!----DD----------DD-----------#----D------------D-----------------------------D--D---------D-----------------------DD----------------------
----------------D---------D--D-----------#----D------------D--------------o------------D-D--D---------D----------------D------DD--------------#-------
---M---------k---------------D-----------#----D------------D--------------o------------o-D--D---------D---------------YD------DD------------g##-------
XXXXXXXXXXXXXX-----k----k----D--------------#-D------------D--------------o----ooo-----o-D--D---------D---------------DD------DD------------###-------
XXXXXXXXXXXXXX--XXXXXXXXXXXXXX--------------#-D------------D--------------D-DD-DDDD-DDDDDD--DDDDDDDDDDD----------------D-XX---DD----XX----g####-------
----------------XXXXXXXXXXXXXX--------------#-DDDDDDDDDDDDD---o--------------------------------------------------g-g-g-D-XX---DD----XX----#####-------
-------------------------------------oo----##------oo---------o----------*-----------------------------------DDDDDDDDDDD-D----------D---g######-------
---------------------------------#---##---###-----------------o-------*--D----------------------ooo---oo----D----------D-D---------*D---#######----F--
------------------------------X--#--y--y--###-k--y----y----------g--g-D--D-----------------------y--Y--y---D-----------D-D*--oooo--D---########----#--
------------------------------XXXXXXXXXXXXXXXXXXXXXXXXXXXXXXXXXXXXXXXXXXXXX---------------XXXXXXXXXXXXXXXXXXXXXXXXXXXXXX--DDDDDDDDD----XXXXXXXXXXXXXXX
------------------------------XXXXXXXXXXXXXXXXXXXXXXXXXXXXXXXXXXXXXXXXXXXXX---------------XXXXXXXXXXXXXXXXXXXXXXXXXXXXXX---------------XXXXXXXXXXXXXXX
