-------------------------------------------------------------D------------D------------------------------DD-------------------------------------------
-------------------------------------------------------------D------------D-------------------------------D-------------------------------------o-----
-------------------------------------------------------------D------------D-------------------------------D-------------------------------------o-----
-------------------------------------------------------------D------------D-------------------------------D-------------------------------------D-----
-------------------------------------------------------------D------------D-------------------------------D------------------------------------D------
-------------------------------------------------------------D------------D-------------------------------D-----------------------------------D-------
o------------------------------------------------------------D*-----------D-------------------------------D-------------------------------------------
X----------------------------------------------------------o--------------D--------------D--------------D-D----------D---------------o--DDDD----------
X----------------------------------------------------------D-X*-----------D-------------------------------D--------------X-----------2X---------D-----
X--------o-------------------------------------------------D-XX*------k---D-------o----D---------o----D---DDDDDDDDDDDD---X------------XD--------D-----
X--------o-------------------------------------o-------------XXXXXXXXXXXXo--------o--------------o-----------------D---X-X-----------oX---------D-----
X--------o---------------------------C-S-S-C---o----------*-------------Xo--------o------D-------o------D-o--------D---X-X-----------2X---------------
XX--------------D-----*-----D------------------o-------*--D-------------Xo--------o------D-------o------D-*----------o-X-X------------X------------F--
XX-M-D--gD-gD-g-D-----D-----D--------ooo-----------k---D--D-------------Xo-D------r------DD------r------D-D----r-----*-X-X-r-----r----X------------#--
XXXXXXXXXXXXXXXXXXXXXXXXXXXXXXXXXX--XXXXX-XXXXXXXXXXXXXXXXXX------------XXXXXX----D----XXXXXX----D----XXXXXXXXXXXXXXXXXXXXXX--XX-XX-XXXXXXXXXXXXXXXXXX
XXXXXXXXXXXXXXXXXXXXXXXXXXXXXXXXXX--XXXXX-XXXXXXXXXXXXXXXXXX------------XXXXXX---------XXXXXX---------XXXXXXXXXXXXXXXXXXXXXX--XX-XX-XXXXXXXXXXXXXXXXXX
