----------------------------------------------------------------------------------------------------------D--------------D----------------------------
----------------------------------------------------------------------------------------------------------D--------------D----------------------------
--------!--!-----------------#--------------------------------------------------------------------------#-D--------------D----------------------------
-----------------------------#--------------------------------------------------------------------------#-D--------------D----------------------------
----------------------------------------------------------------------------------------------------------D--------------D----------------------------
--------!--!--------------#--------------------------------D-----------------------------------------#----D--------------D--------------------o-------
--------------------------#--------o-----------------------------------------------------------------#----D------o-------D------o-------------#-------
---M---------k------------#-------Xo-----------------------------------------------------------------#----D-----o-o------D-----o-o-----------##-------
XXXXXXXXXXXXXX---------------#----Xo-------------------TT----------D-------------o----------------------#-D----o-o-o-----D----o-o-o--------o-##-------
XXXXXXXXXXXXXX---------------#-XXXXXTTXXXXXX-----------tt-----SSS@SSSS---D------o-o---------------------#-DDDDDDDDDDDDD--DDDDDDDDDDDDD-----#-##-------
-----------------------------#-XXXXXttXXXXXX-------TToott------------S---D-----o-o-o--------------------#---------------------------------##-##-------
----------------------oo----##------tt-------------ttoott-------------SSSD-K--o-o-o-o--K---------oo----##--------------------------------###-##-------
------------------#---##---###------tt-------------ttoott-----oo-------ooD-D---D---D---D-----#---##---###------TT-------------TT-------o-###-##----F--
---------------X--#--y--y--###------tt-------------ttggtt-----oo--g----ooD---D---D---D----X--#--y--y--###------tt-------------tt-------#-###-##g--g#--
---------------XXXXXXXXXXXXXXX------tt-------XXXXXXXXXXXXXXXXXXXXXXXXXXXXXXXXXXXXXXXXXXXXXXXXXXXXXXXXXXXX--TT--tt---TT----TT--tt---TT--X-XXX-XXXXXXXXX
---------------XXXXXXXXXXXXXXX------tt-------XXXXXXXXXXXXXXXXXXXXXXXXXXXXXXXXXXXXXXXXXXXXXXXXXXXXXXXXXXXXX-tt--tt---tt--X-tt--tt---tt--X-XXX-XXXXXXXXX
