---------------------------------------------------U----------------------------------------------------D-D--------------D------------D---------------
--------------------------------------------------------------------------------------------------------D-D--------------D------------D---------------
---------------------------------------------------D----------------------------------------------------D-D--------------D------------D---------------
---M---X--gX-g---------------------------------------D--------------------------------------------------D-D--------------D------------D-------o--o----
XXXXXXXXXXXXXX-------------------------------------D----------------------------------------------------D-D--------------D------------D---------------
XXXXXXXXXXXXXX---------------------------------------D--------------------------------------------------D-D--------------D------------D---------------
-------------X-------------------------------------D-------------------------------------o--------------D-D------o-------D------------D-------#-------
-------------X----------------------------------r------r------------------o--------------o--------------D-D-----o-o------D------------D-----g##-------
---------------------------------------------%%%%%%%%%%%%%%%--------------D--------------o--------------D-D----o-o-o-----D------------D-----###-------
--------------------------------------------X%%%%%%%%%%%%%%%--------------D--------------DDD---oooooo---D-DDDDDDDDDDDDD--D----oo-----oD---g####-------
-D-D-DD--D-D-DD---------------------TT-----XX-------||--------o--------------o-----------------TTTTTT---D----------------D-----------*D---#####-------
-D-D-D-D-D-D-D---------------------otto-----X-------||--------o----------*---o----------*------tttttt--------------------Do---TT--------g######-------
-DD--DD--D-D-DD-D-----*-----D------otto-----X-------||--------o-------*--D---o-------*--D------tttttt-D--------TT--------D*---tt--oo----#######----F--
-D-D-D-D--D---D-D-----D-----D-X-X--otto--X-X--------||------------k---D--D------g--g-D--D------tttttt-D--------tt-------------tt-------########----#--
-D-D-D-D--D--DDXXXXXXXXXXXXXXXXXXXXXXXXXXXXXX-------||------XXXXXXXXXXXXXXXXXXXXXXXXXXXXXX-----tttttt-DTT--TT--tt---TT--XXXX--tt--TT-XXXXXXXXXXXXXXXXX
---------------XXXXXXXXXXXXXXXXXXXXXXXXXXXXXX-------||------XXXXXXXXXXXXXXXXXXXXXXXXXXXXXX-----tttttt-XttX-tt--tt---tt--X-----tt--tt---XXXXXXXXXXXXXXX
