-------------------------------D-----------------------------D------------D--------------------D----D-----D------------D------------------------------
-------------------------------D-----------------------------D------------D--------------------D----D-----D------------D------------------------------
-------------------------------D-----------------------------D------------D--------------------D----D-----D------------D------------------------------
---M---X--gX-g-----------------D------------D----------------D------------D--------------------D----D-----D------------D------------------------o-----
XXXXXXXXXXXXXX-----------------D*-----------D----------------D------------D--------------------Do--oD-----D------------D-----------------------o------
XXXXXXXXXXXXXX-----------------DD----------DD----------------D------------D--------------------Do--oD-----D------------D----------------------o-------
-------------X-----------------D---------D--D--------------o-D------------D--------------D----------------D*-----------D--------------o-------#-------
-------------X------------------------------D--------------o-D------------D-------------YD-----------------------------D--------------o------##-------
-------------------oooo-----g-----k----k----D--------------o-D------------D-------------DD---#y-#--#y-#---X*-----------D--------------o------##-------
---------------##--####--#####-XXXXXXXXXXXXXX--------------D-D------------D--------------D#--####--####---XX*------k---D--------------D---o--##-------
-D-D-DD--D-D-DD-#-y#--#-y#-----XXXXXXXXXXXXXX--o-------------DDDDDDDDDDDDD---------g-g-g-D----------------XXXXXXXXXXXXo---o---------------#--##-------
-D-D-D-D-D-D-D---##----##----------------------o----------*-------oo-----------DDDDDDDDDDD---------------------------Xo---o----------*---##--##-------
-DD--DD--D-D-DD--------------------------------o-------*--D-------------------D----------D---------------------------Xo---o-------*--D---##--##----F--
-D-D-D-D--D---D-----------------------------------g--g-D--D--k--y----y-------D-----------D---------------------------Xo------g--g-D--D-#-##--##----#--
-D-D-D-D--D--DD------------------------------XXXXXXXXXXXXXXXXXXXXXXXXXXXXXXXXXXXXXXXXXXXXX---------------------------XXXXXXXXXXXXXXXXXXX-XX--XXXXXXXXX
---------------------------------------------XXXXXXXXXXXXXXXXXXXXXXXXXXXXXXXXXXXXXXXXXXXXX---------------------------XXXXXXXXXXXXXXXXXXX-XX--XXXXXXXXX
