-------------------------------D-----------------------------D------------D---------------DD---------------D---------D--------------------------------
-------------------------------D--------------------------L--D------------D----------------D---------------D---------D--------------------------------
-----------------------------#-D-----------------------------D------------D----------------D---------------D---------D--------------------------------
---M---X--gX-g---------------#-D------------D------------K---D------------D----------------D---------------D---------D--------------------------o-----
XXXXXXXXXXXXXX-----------------D*-----------D---------%%%%%--D------------D----------------D---------------D---------D-------------------------o------
XXXXXXXXXXXXXX------------#----DD----------DD---------%%%%%--D------------D----------------D---------------D---------D------------------------o-------
-------------X------------#----D---------D--D-----------||---D------------D--------------D-D---------------D---------D----------------D-------#-------
-------------X------------#-----------------D---k---k---||---D------------D-------------YD-D----------D----D---------D---------------YD------##-------
-----------------------------#----k----k----D-%%%%%%%%%%%%%--D------------D-------------DD-D---------------D---------D---------------DD------##-------
-----------------------------#-XXXXXXXXXXXXXX-%%%%%%%%%%%%%--D------------D--------------D-DDDDDDDDDDDD----DDDDDDDDDDD----------------D---o--##-------
-D-D-DD--D-D-DD--------------#-XXXXXXXXXXXXXX-------||-------DDDDDDDDDDDDD---------g-g-g-D----------D---X-----------------------g-g-g-D---#--##-------
-D-D-D-D-D-D-D--------oo----##----------------------||------------oo-----------DDDDDDDDDDD-o--------D---X-------------------DDDDDDDDDDD--##--##-------
-DD--DD--D-D-DD---#---##---###----------------------||------------------------D----------D-*----------o-X------ooo---oo----D----------D--##--##----F--
-D-D-D-D--D---DX--#--y--y--###----------------------||-------k--y----y-------D-----------D-D----r-----*-X-------y--Y--y---D-----------D#-##--##----#--
-D-D-D-D--D--DDXXXXXXXXXXXXXXX----------------------||------XXXXXXXXXXXXXXXXXXXXXXXXXXXXXXXXXXXXXXXXXXXXXXXXXXXXXXXXXXXXXXXXXXXXXXXXXXXX-XX--XXXXXXXXX
---------------XXXXXXXXXXXXXXX----------------------||------XXXXXXXXXXXXXXXXXXXXXXXXXXXXXXXXXXXXXXXXXXXXXXXXXXXXXXXXXXXXXXXXXXXXXXXXXXXX-XX--XXXXXXXXX
