------------------------------------------------------------------------------------------DD----------------------------------------------------------
-------------------------------------------------------------------------L-----------------D----------------------------------------------------------
-------------------------------------------------------------------------------------------D----------------------------------------------------------
------------------------------------------------------------------------K------------------D--------------------------------------------------o--o----
---------------------------------------------------------------------%%%%%-----------------D--------------D---------o-*D------------------------------
---------------------------------------------------------------------%%%%%-----------------D--------------D---------D--D------------------------------
o----------------------------------------------------------o-----------||------------------D--------------D------------D----------------------#-------
X----------------------------------------------------------o---k---k---||----------------D-D----------D---D*----o------D--------------------g##-------
X----------------------------------------------------------o-%%%%%%%%%%%%%-----------------D--------------D-----D------D--------------------###-------
X--------o-------------------------------------------------D-%%%%%%%%%%%%%--------o----D---DDDDDDDDDDDD---D---o-------*D------------------g####-------
X--------o-------------------------------------o-------------------||-------------o-----------------D---X-D---D--------D-------o-----*D---#####-------
X--------o---------------------------C-S-S-C---o----------*--------||-------------o------D-o--------D---X-D*------o----D-------o----ooD-g######-------
XX--------------D-----*-----D------------------o-------*--D--------||-------------o------D-*----------o-X-D-------D----Do------o----DDD-#######----F--
XX-M-D--gD-gD-g-D-----D-----D--------ooo----------g--g-D--D--------||------D------r------D-D----r-----*-X-------r------Do------g-----*D########----#--
XXXXXXXXXXXXXXXXXXXXXXXXXXXXXXXXXX--XXXXX-XXXXXXXXXXXXXXXXXX-------||------XXX----D----XXXXXXXXXXXXXXXXXXX---X--X--X---XX------X-----XXXXXXXXXXXXXXXXX
XXXXXXXXXXXXXXXXXXXXXXXXXXXXXXXXXX--XXXXX-XXXXXXXXXXXXXXXXXX-------||------XXX---------XXXXXXXXXXXXXXXXXXX---X--X--X---XX------X-----XXXXXXXXXXXXXXXXX
