-----------------------------------------------------------------------------------------------------------D---------D--------------------------------
-------------------------------------------------------------------------L---------------------------------D---------D--------------------------------
--------!--!--------------------------------#---------------------------------------------------------YYY--D---------D----------------#---------------
--------------------------------------------#---------------------------K-----------------------------DDD--D---------D----------------#-------o--o----
-----------------------------------------------------------g---------%%%%%------------------------------D--D---------D--------------------------------
--------!--!-----------------------------#---------------DDD---------%%%%%---------------D--------------D--D---------D-------------#------------------
--------------------o--------------------#-------------TTDD------------||-----------------------------D-D--D---------D-------------#----------#-------
---M---------k-----Xo--------------------#-------------tt------k---k---||-----------------------------o-D--D---------D-------------#--------g##-------
XXXXXXXXXXXXXX-----Xo-----------------------#----g-g---tt----%%%%%%%%%%%%%-----------TT-------ooo-----o-D--D---------D----------------#-----###-------
XXXXXXXXXXXXXX--XXXXXTTXXXXXX---------------#XXXXXXXTTXXXXXX-%%%%%%%%%%%%%-----------tt----DD-DDDD-DDDDDD--DDDDDDDDDDD----------------#---g####-------
----------------XXXXXttXXXXXX---------------#XXXXXXXttXXXXXX-------||------------TToott-----------------------------------------------#---#####-------
---------------------tt--------------oo----##-------tt-------------||------------ttoott----------------------------------------oo----##-g######-------
---------------------tt----------#---##---###-------tt-------------||------------ttoott------------------------ooo---oo----#---##---###-#######----F--
---------------------tt-------X--#--y--y--###-------tt-------------||------------ttggtt-------------------------y--Y--y-X--#--y--y--###########----#--
---------------------tt-------XXXXXXXXXXXXXXX-------tt-------------||------XXXXXXXXXXXXXXX---------------XXXXXXXXXXXXXXXXXXXXXXXXXXXXXXXXXXXXXXXXXXXXX
---------------------tt-------XXXXXXXXXXXXXXX-------tt-------------||------XXXXXXXXXXXXXXX---------------XXXXXXXXXXXXXXXXXXXXXXXXXXXXXXXXXXXXXXXXXXXXX
