----------------------------------------------D-------------------------------------------------------------------------------------------------------
----------------------------------------------D-------------------------------------------------------------------------------------------------------
----------------------------------------------D-------------------------------------------------------------------------------------------------------
----------------------------------------------D-----------------------------------------------------------------------D-------------------------o-----
----------------------------------------------D---------------------------------oo-----------------------------------DD------------------------o------
----------------------------------------------D----------------------------------------oX-----------------o-------oo--D-----------------------o-------
-----------------------------------o----------D------o---------------------------------oX-----------------o-------TT--D-----------------------#-------
-----------------------------D----Xo----------D-----o-o-------------------D------------XX--------------o--o-------tt--D----------------------##-------
X------o--o-----------------------Xo----------D----o-o-o--------------------XXX----XX--XX--X-----------2X-o--oo-------D----------------------##-------
X------o--o-----------o----D---XXXXXTTXXXXXX--DDDDDDDDDDDDD--------o----D---XXX----XX--XX--X------------X-o--TT-------D---------------X---o--##-------
X---------------------o--------XXXXXttXXXXXX-----------------------o----------X---------X--X-----------oX-o--tt---oo--D-------TT-----XX---#--##-------
X------!--!-----------o------D------tt-----------------------------o------DX--X---------X--X-----------2X-o-------TT--D------otto-----X--##--##-------
X---------------------o------D------tt-------------TT--------------o------DX--X---------X--X------------X---------tt--D------otto-----X--##--##----F--
X--M--------g-gD------r------D------tt-------------tt-------D------r------D---X---------X--X-r-----r----X-----g---tt--D-X-X--otto--X-X-#-##--##----#--
XXXXXXXXXXXXXXXXXX----D----XXX------tt---------TT--tt---TT--XXX----D----XXXXXXX---------X-XXXX--XX-XX-XXXX---XX-X--XX-XXXXXXXXXXXXXXXXXX-XX--XXXXXXXXX
XXXXXXXXXXXXXXXXXX---------XXX------tt-------X-tt--tt---tt--XXX---------XXXXXXX---------X-XXXX--XX-XX-XXXX---XX-X--XX-XXXXXXXXXXXXXXXXXX-XX--XXXXXXXXX
