----------------D-------------------------------------------------------------------------------------------------------------------------------------
----------------D-------------------------------------------------------------------------------------------------------------------------------------
--------!--!----D-------------------------------------------------------------------------------------------------------------------------------------
----------------D------------D------------------------------------------------------------------------------------------------------------------------
----------------D*-----------D------------------------------------------------------------------------------------------------------------------------
--------!--!----DD----------DD--------------------------------------------------------------------------------------------------------X-------o-------
----------------D---------D--D--------------------------------------------o-----------------------------------------------------------X-------#-------
---M---------k---------------D--------------------------------------------o--------------o-------------o---------------D-------------XX------##-------
XXXXXXXXXXXXXX-----k----k----D--------------------------------------------o--------------D-X-----------2X----------------XXX--XXXXX-XXX----o-##-------
XXXXXXXXXXXXXX--XXXXXXXXXXXXXX--------o-----------------------------------D--------------D-X------------X-------o----D---XXX--XXXXX-XXX----#-##-------
----------------XXXXXXXXXXXXXX--------o-----------------------o--------------o-------------X-----------oX-------o--------------------oX---##-##-------
--------------------------------------o--------2122222222X----o----------*---o----------*--X-----------2X-------o------DX------------oX--###-##-------
--------------------------------------o------------ooooooX----o-------*--D---o-------*--D--X------------X-------o------DX------------oXo-###-##----F--
--------------------------------------o--------g--gooooooX-------g--g-D--D-------k---D--D--X-r-----r----XD------r------D--------g----oX#-###-##g--g#--
------------------------------X-------X-----XXXXXXXXXXXXXXXXXXXXXXXXXXXXXXXXXXXXXXXXXXXXXXXXXX--XX-XX-XXXXXX----D----XXXXXXX--XXXXX-XXXX-XXX-XXXXXXXXX
------------------------------X-------X-----XXXXXXXXXXXXXXXXXXXXXXXXXXXXXXXXXXXXXXXXXXXXXXXXXX--XX-XX-XXXXXX---------XXXXXXX--XXXXX-XXXX-XXX-XXXXXXXXX
