-------------------------------D------------------------------------------------------------------------D---------------------------------------------
-------------------------------D------------------------------------------------------------------------D---------------------------------------o-----
-------------------------------D------------------------------------------------------------------------D---------------------------------------o-----
-------------------------------D------------------------------------------------------------------------D---------------------------------------D-----
-------------------------------D---------------------------------oo----------------------g--------------D--------------------------------------D------
-------------------------------D----------------------------------------oX-------------DDD--------------D-------------------------------------D-------
o------------------------------D------o---------------------------------oX-----------TTDD---------------D---------------------------------------------
X------------------------------D-----o-o-------------------D------------XX-----------tt-----------------D-------------------------------DDDD----------
X------------------------------D----o-o-o--------------------XXX----XX--XX-----g-g---tt-----------------D---------------------------------------D-----
X--------o---------------------DDDDDDDDDDDDD--------o----D---XXX----XX--XX-XXXXXXXTTXXXXXXDD---oooooo---D--------o--------------------XD--------D-----
X--------o------------------------------------------o----------X---------X-XXXXXXXttXXXXXX-----TTTTTT---D--------o------------TT-----XX---------D-----
X--------o------------C-S-S-C-----------------------o------DX--X---------X--------tt-----------tttttt------------o-----------otto-----X---------------
XX----------------------------------TT--------------o------DX--X---------X--------tt-----------tttttt-D----------o-----------otto-----X------------F--
XX-M-D--gD-gD-g-------ooo-----------tt-------D------r------D---X---------X--------tt-----------tttttt-D----------o------X-X--otto--X-X-------------#--
XXXXXXXXXXXXXXXXXXX--XXXXX-XXX--TT--tt---TT--XXX----D----XXXXXXX---------X--------tt-----------tttttt-DTTX-------X-----XXXXXXXXXXXXXXXXXXXXXXXXXXXXXXX
XXXXXXXXXXXXXXXXXXX--XXXXX-XXXX-tt--tt---tt--XXX---------XXXXXXX---------X--------tt-----------tttttt-XttX-------X-----XXXXXXXXXXXXXXXXXXXXXXXXXXXXXXX
