---------------------------------------------------------------------------------U---------D----------------------------------------------------------
-------------------------------------------------------------------------------------------D----------------------------------------------------o-----
--------!--!--------------------------------#------------------------------------D---------D----------------------------------------YYY---------o-----
--------------------------------------------#--------------------------------------D-------D----------------------------------------DDD---------D-----
-----------------------------------------------------------g---------------------D---------D------------------------------------------D--------D------
--------!--!-----------------------------#---------------DDD-----------------------D-------D---------------------------D--------------D-------D-------
--------------------o--------------------#-------------TTDD---------------D------D---------D------o---------------------------------D-D---------------
---M---------k-----Xo--------------------#-------------tt----------------YD---r------r-----D-----o-o--------------------------------o-D-DDDD----------
XXXXXXXXXXXXXX-----Xo-----------------------#----g-g---tt----------------DD%%%%%%%%%%%%%%%-D----o-o-o--------------TT-------ooo-----o-D---------D-----
XXXXXXXXXXXXXX--XXXXXTTXXXXXX---------------#XXXXXXXTTXXXXXX--------------D%%%%%%%%%%%%%%%-DDDDDDDDDDDDD-----------tt----DD-DDDD-DDDDDDD--------D-----
----------------XXXXXttXXXXXX---------------#XXXXXXXttXXXXXX--------g-g-g-D-------||---------------------------TToott---------------------------D-----
---------------------tt--------------oo----##-------tt----------DDDDDDDDDDD-------||---------------------------ttoott---------------------------------
---------------------tt----------#---##---###-------tt---------D----------D-------||------------TT-------------ttoott------------------------------F--
---------------------tt-------X--#--y--y--###-------tt--------D-----------D-------||------------tt-------------ttggtt------------------------------#--
---------------------tt-------XXXXXXXXXXXXXXX-------tt------XXXXXXXXXXXXXXX-------||--------TT--tt---TT--XXXXXXXXXXXXXXX---------------XXXXXXXXXXXXXXX
---------------------tt-------XXXXXXXXXXXXXXX-------tt------XXXXXXXXXXXXXXX-------||------X-tt--tt---tt--XXXXXXXXXXXXXXX---------------XXXXXXXXXXXXXXX
