------------------------------------------------------------------------------------------------------------------------------------------------------
------------------------------------------------------------------------------------------------------------------------------------------------------
------------------------------------------------------------------------------------------------------------------------------------------------------
------------------------------------------------------------------------------------------------------------------------------------------------------
-------------------------------------------------------------------------------------------------------------------------D---------o-*D---------------
-------------------------------------------------------------------------------------------------------------------------D---------D--D-------o-------
o-------------------------------------------------------------------------o----------------------------------------------D------------D-------#-------
X----------------------------------------------------------D--------------o----------------------------------------------D*----o------D------##-------
X-------------------------------------------------------------------------o------o---------------------------------------D-----D------D----o-##-------
X--------o------------------------------------------o----D----------------D-----o-o---------------o--------------o-------D---o-------*D----#-##-------
X--------o------------------------------------------o---------o----------------o-o-o--------------o--------------o-------D---D--------D---##-##-------
X--------o------------C-S-S-C-----------------------o------D--o----------*----o-o-o-o-------------o--------------o-------D*------o----D--###-##-------
XX-----------------------------D-----*-----D--------o------D--o-------*--D-D-----|-------D--------o--------------o-------D-------D----Do-###-##----F--
XX-M-D--gD-gD-g-------ooo------D-----D-----D-D------r------D-----g--g-D--D-X-k---|----k--X--------o--------------o-------------r------D#-###-##g--g#--
XXXXXXXXXXXXXXXXXXX--XXXXX-XXXXXXXXXXXXXXXXXXXXX----D----XXXXXXXXXXXXXXXXXXXXXXXXXXXXXXXXXX-------X-----XX-------X-----XX---X--X--X---XX-XXX-XXXXXXXXX
XXXXXXXXXXXXXXXXXXX--XXXXX-XXXXXXXXXXXXXXXXXXXXX---------XXXXXXXXXXXXXXXXXXXXXXXXXXXXXXXXXX-------X-----XX-------X-----XX---X--X--X---XX-XXX-XXXXXXXXX
