----------------D-------------------------------------------------------------------------------DD-------DD-------------------------------------------
----------------D-------------------------------------------------------------------------------DD--------D-------------------------------------------
----------------D-------------------------------------------------------------------------------DD--------D-------------------------------------------
---M---X--gX-g--D------------D------------------------------------------------------------------DD--------D-------------------------------------o-----
XXXXXXXXXXXXXX--D*-----------D--------------------oo--------------------------------------------DD--------D--------------D---------o-*D--------o------
XXXXXXXXXXXXXX--DD----------DD--------------X------------oX-------------------------------------DD--------D--------------D---------D--D-------o-------
-------------X--D---------D--D--------------X------------oX---------------o---------------------DD--------D--------------D------------D-------#-------
-------------X---------------D-------------XX------------XX---------------o--------------o------DD--------D----------D---D*----o------D------##-------
-------------------k----k----D-XXX--XXXXX-XXX-XXX----XX--XX---------------o--------------D------DD--------D--------------D-----D------D------##-------
----------------XXXXXXXXXXXXXX-XXX--XXXXX-XXX-XXX----XX--XX---------------D--------------D-XX---DD----XX--DDDDDDDDDDDD---D---o-------*D---o--##-------
-D-D-DD--D-D-DD-XXXXXXXXXXXXXX-------------oX---X---------X---o--------------o-------------XX---DD----XX-----------D---X-D---D--------D---#--##-------
-D-D-D-D-D-D-D----------------X------------oXX--X---------X---o----------*---o----------*--D----------D---o--------D---X-D*------o----D--##--##-------
-DD--DD--D-D-DD---------------X------------oXX--X---------X---o-------*--D---o-------*--D--D---------*D---*----------o-X-D-------D----D--##--##----F--
-D-D-D-D--D---D-----------------------g----oX---X---------X------g--g-D--D-------k---D--D--D*--oooo--D----D----r-----*-X-------r------D#-##--##----#--
-D-D-D-D--D--DD---------------XXXX--XXXXX-XXXXXXX---------X-XXXXXXXXXXXXXXXXXXXXXXXXXXXXXX--DDDDDDDDD----XXXXXXXXXXXXXXXX---X--X--X---XX-XX--XXXXXXXXX
------------------------------XXXX--XXXXX-XXXXXXX---------X-XXXXXXXXXXXXXXXXXXXXXXXXXXXXXX---------------XXXXXXXXXXXXXXXX---X--X--X---XX-XX--XXXXXXXXX
