------------------------------------------------------------------------------------------------------------------------DD----------------------------
-------------------------------------------------------------------------------------------------------------------------D----------------------o-----
--------!--!-------------------------------------------------------------------------------------------------------------D----------------------o-----
-------------------------------------------------------------------------------------------------------------------------D----------------------D-----
-------------------------------------------------------------------------------------------------------------------------D---------------------D------
--------!--!-------------------------------------------------------------------------------------------------------------D--------------------D-------
-------------------------------------------------------------------------------------------------------------------------D----------------------------
---M---------k---------------------------------------------D-----------------------------------------------------------D-D----------D---DDDD----------
XXXXXXXXXXXXXX-----------------------------------------------------------------------------------------------------------D----------------------D-----
XXXXXXXXXXXXXX--------------------------------------o----D-------------------------o--------------o-------------o----D---DDDDDDDDDDDD--D--------D-----
----------------------------------------------------o------------------------------o--------------o-------------o-----------------D---X---------D-----
----------------------C-S-S-C-----------------------o------D--2122222222X----------o--------------o-------------o------D-o--------D---X---------------
-------------------------------D-----*-----D--------o------D------ooooooX----------o--------------o-------------o------D-*----------o-X------------F--
----------------------ooo------D-----D-----D-D------r------D--g--gooooooX----------o--------------o------D------r------D-D----r-----*-X------------#--
---------------XXXX--XXXXX-XXXXXXXXXXXXXXXXXXXXX----D----XXXXXXXXXXXXXXXXXXX-------X-----XX-------X-----XXXX----D----XXXXXXXXXXXXXXXXXXXXXXXXXXXXXXXXX
---------------XXXX--XXXXX-XXXXXXXXXXXXXXXXXXXXX---------XXXXXXXXXXXXXXXXXXX-------X-----XX-------X-----XXXX---------XXXXXXXXXXXXXXXXXXXXXXXXXXXXXXXXX
