----------------------------------------------------------------------------------------------------------D-------------------------------------------
----------------------------------------------------------------------------------------------------------D-------------------------------------------
--------!--!--------------------------------#-------------------------------------------------------------D-------------------------------------------
--------------------------------------------#-------------------------------------------------------------D-----------------------------------o--o----
----------------------------------------------------------------------------------------------------------D-------------------------------------------
--------!--!-----------------------------#-----------------D----------------------------------------------D-------------------------------------------
-----------------------------------------#--------------------------------D-------------------------------D------o--------------------D-------#-------
---M---------k---------------------------#-------------------------------YD-------------------------------D-----o-o------------------YD-----g##-------
XXXXXXXXXXXXXX------------------------------#----------TT----------------DD-------------------------------D----o-o-o-----------------DD-----###-------
XXXXXXXXXXXXXX---------------X--------------#----------tt-----------------D-------------------------------DDDDDDDDDDDDD---------------D---g####-------
---------------------TT-----XX--------------#------TToott-----------g-g-g-D-----------------------------------------------------g-g-g-D---#####-------
--------------------otto-----X-------oo----##------ttoott-------DDDDDDDDDDD--2122222222X------------------------------------DDDDDDDDDDD-g######-------
--------------------otto-----X---#---##---###------ttoott------D----------D------ooooooX-----------------------TT----------D----------D-#######----F--
---------------X-X--otto--X-X-X--#--y--y--###------ttggtt-----D-----------D--g--gooooooX-----------------------tt---------D-----------D########----#--
---------------XXXXXXXXXXXXXXXXXXXXXXXXXXXXXXXXXXXXXXXXXXXXXXXXXXXXXXXXXXXXXXXXXXXXXXXXXXX----D--y---D-----TT--tt---TT--XXXXXXXXXXXXXXXXXXXXXXXXXXXXXX
---------------XXXXXXXXXXXXXXXXXXXXXXXXXXXXXXXXXXXXXXXXXXXXXXXXXXXXXXXXXXXXXXXXXXXXXXXXXXXXX---TTXXTT--XXX-tt--tt---tt--XXXXXXXXXXXXXXXXXXXXXXXXXXXXXX
