-------------------------------------------------------------------------------------------D--------------D--------------D----------------------------
-------------------------------------------------------------------------------------------D--------------D--------------D----------------------------
--------!--!-------------------------------------------------------------------------------D--------------D--------------D----------------------------
-------------------------------------------------------------------------------------------D--------------D--------------D----------------------o-----
-------------------------------------------------------------------------------------------D--------------D--------------D---------------------o------
--------!--!-----------------------------------------------------------------------------D-D--------------D--------------D--------------------o-------
-----------------------------------o--------------------------------------D----------------D------o-------D------o-------D------o-------------#-------
---M---------k--------------------Xo-------------------------------------YD----------------D-----o-o------D-----o-o------D-----o-o-----------##-------
XXXXXXXXXXXXXX-----oooo-----g-----Xo----------------D--------------------DD----------TT----D----o-o-o-----D----o-o-o-----D----o-o-o----------##-------
XXXXXXXXXXXXXX-##--####--#####-XXXXXTTXXXXXX---SSS@SSSS---D---------------D----------tt----DDDDDDDDDDDDD--DDDDDDDDDDDDD--DDDDDDDDDDDDD----o--##-------
----------------#-y#--#-y#-----XXXXXttXXXXXX----------S---D---------g-g-g-D------TToott---------------------------------------------------#--##-------
-----------------##----##-----------tt-----------------SSSD-----DDDDDDDDDDD------ttoott--------------------------------------------------##--##-------
------------------------------------tt---------oo-------ooD----D----------D------ttoott---------TT-------------TT-------------TT---------##--##----F--
------------------------------------tt---------oo--g----ooD---D-----------D------ttggtt---------tt-------------tt-------------tt-------#-##--##----#--
------------------------------------tt-------XXXXXXXXXXXXXXXXXXXXXXXXXXXXXXXXXXXXXXXXXXXXX--TT--tt---TT----TT--tt---TT----TT--tt---TT--X-XX--XXXXXXXXX
------------------------------------tt-------XXXXXXXXXXXXXXXXXXXXXXXXXXXXXXXXXXXXXXXXXXXXXX-tt--tt---tt--X-tt--tt---tt--X-tt--tt---tt--X-XX--XXXXXXXXX
