-------------------------------------------------------------D------------D---------------------DD---------D---------D---D------------D---------------
-------------------------------------------------------------D------------D---------------------DD---------D---------D---D------------D---------------
--------!--!--------------------------------#----------------D------------D---------------------DD---------D---------D---D------------D---------------
--------------------------------------------#----------------D------------D---------------------DD---------D---------D---D------------D---------------
-------------------------------------------------------------D------------D---------------------DD---------D---------D---D------------D---------------
--------!--!-----------------------------#-------------------D------------D---------------------DD---------D---------D---D------------D-------o-------
-----------------------------------------#-----------------o-D------------D---------------------DD---------D---------D---D------------D-------#-------
---M---------k---------------------------#-----------------o-D------------D--------------o------DD---------D---------D---D------------D------##-------
XXXXXXXXXXXXXX------------------------------#--------------o-D------------D--------------D------DD---------D---------D---D------------D----o-##-------
XXXXXXXXXXXXXX------------------------------#--------------D-D------------D--------------D-XX---DD----XX---DDDDDDDDDDD---D------------D----#-##-------
--------------------------------------------#--o-------------DDDDDDDDDDDDD---o-------------XX---DD----XX-----------------DDDDDDDDDDDDD----##-##-------
-------------------------------------oo----##--o----------*-------oo---------o----------*--D----------D-----------------------oo---------###-##-------
----------------D-----*-----D----#---##---###--o-------*--D------------------o-------*--D--D---------*D--------ooo---oo----------------o-###-##----F--
----------------D-----D-----D-X--#--y--y--###-----g--g-D--D--k--y----y-----------k---D--D--D*--oooo--D----------y--Y--y--k--y----y-----#-###-##g--g#--
---------------XXXXXXXXXXXXXXXXXXXXXXXXXXXXXXXXXXXXXXXXXXXXXXXXXXXXXXXXXXXXXXXXXXXXXXXXXXX--DDDDDDDDD----XXXXXXXXXXXXXXXXXXXXXXXXXXXXXXX-XXX-XXXXXXXXX
---------------XXXXXXXXXXXXXXXXXXXXXXXXXXXXXXXXXXXXXXXXXXXXXXXXXXXXXXXXXXXXXXXXXXXXXXXXXXX---------------XXXXXXXXXXXXXXXXXXXXXXXXXXXXXXX-XXX-XXXXXXXXX
