----------------D--------------------------------------------D------------D----------------------------------------------D------------D---------------
----------------D--------------------------------------------D------------D----------------------------------------------D------------D---------------
----------------D--------------------------------------------D------------D------------------------------------------YYY-D------------D---------------
---M---X--gX-g--D------------D-------------------------------D------------D------------------------------------------DDD-D------------D-------o--o----
XXXXXXXXXXXXXX--D*-----------D-------------------------------D------------D--------------------------------------------D-D------------D---------------
XXXXXXXXXXXXXX--DD----------DD-------------------------------D------------D--------------------------------------------D-D------------D---------------
-------------X--D---------D--D-----------------------------D-D------------D-----------------------------D------------D-D-D*-----------D-------#-------
-------------X---------------D----------------------------YD-D------------D----------------------------YD------------o-D--------------D-----g##-------
-------------------k----k----D----oooo-----g--------------DD-D------------D------o---------------------DD----ooo-----o-D-X*-----------D-----###-------
----------------XXXXXXXXXXXXXX##--####--#####--------------D-D------------D-----o-o---------------------D-DD-DDDD-DDDDDD-XX*------k---D---g####-------
-D-D-DD--D-D-DD-XXXXXXXXXXXXXX-#-y#--#-y#------------g-g-g-D-DDDDDDDDDDDDD-----o-o-o--------------g-g-g-D----------------XXXXXXXXXXXXo----#####-------
-D-D-D-D-D-D-D------------------##----##---------DDDDDDDDDDD------oo-------K--o-o-o-o--K------DDDDDDDDDDD---------------------------Xo--g######-------
-DD--DD--D-D-DD---------------------------------D----------D---------------D---D---D---D-----D----------D---------------------------Xo--#######----F--
-D-D-D-D--D---D--------------------------------D-----------D-k--y----y-------D---D---D------D-----------D---------------------------Xo-########----#--
-D-D-D-D--D--DD------------------------------XXXXXXXXXXXXXXXXXXXXXXXXXXXXXXXXXXXXXXXXXXXXXXXXXXXXXXXXXXXX---------------------------XXXXXXXXXXXXXXXXXX
---------------------------------------------XXXXXXXXXXXXXXXXXXXXXXXXXXXXXXXXXXXXXXXXXXXXXXXXXXXXXXXXXXXX---------------------------XXXXXXXXXXXXXXXXXX
