-------------------------------D-------------------------------------------------DD--------D------------D-D-------------------------------------------
-------------------------------D-------------------------------------------------DD--------D------------D-D-------------------------------------------
--------!--!-------------------D-------------------------------------------------DD--------D------------D-D-------------------------------------------
-------------------------------D------------D------------------------------------DD--------D------------D-D-------------------------------------o-----
-------------------------------D*-----------D------------------------------------DD--------D------------D-D------------------------------------o------
--------!--!-------------------DD----------DD------------------------------------DD--------D------------D-D-----------------------------------o-------
--------------------o----------D---------D--D--------------o---------------------DD--------D*-----------D-D------o----------------------------#-------
---M---------k-----Xo-----------------------D--------------o--------------o------DD---------------------D-D-----o-o--------------------------##-------
XXXXXXXXXXXXXX-----Xo-------------k----k----D--------------o--------------D------DD--------X*-----------D-D----o-o-o-------------------------##-------
XXXXXXXXXXXXXX--XXXXXTTXXXXXX--XXXXXXXXXXXXXX--------------D--------------D-XX---DD----XX--XX*------k---D-DDDDDDDDDDDDD---------------X---o--##-------
----------------XXXXXttXXXXXX--XXXXXXXXXXXXXX--o--------------o-------------XX---DD----XX--XXXXXXXXXXXXo----------------------TT-----XX---#--##-------
---------------------tt------------------------o----------*---o----------*--D----------D--------------Xo---------------------otto-----X--##--##-------
---------------------tt------------------------o-------*--D---o-------*--D--D---------*D--------------Xo-------TT------------otto-----X--##--##----F--
---------------------tt---------------------------g--g-D--D-------k---D--D--D*--oooo--D---------------Xo-------tt-------X-X--otto--X-X-#-##--##----#--
---------------------tt----------------------XXXXXXXXXXXXXXXXXXXXXXXXXXXXXX--DDDDDDDDD----------------XXX--TT--tt---TT--XXXXXXXXXXXXXXXX-XX--XXXXXXXXX
---------------------tt----------------------XXXXXXXXXXXXXXXXXXXXXXXXXXXXXX---------------------------XXXX-tt--tt---tt--XXXXXXXXXXXXXXXX-XX--XXXXXXXXX
