------------------------------------------------------------------------------------------------DD-------DD-------------------------------------------
------------------------------------------------------------------------------------------------DD--------D-------------------------------------o-----
------------------------------------------------------------------------------------------------DD--------D-------------------------------------o-----
---M---X--gX-g----------------------------------------------------------------------------------DD--------D-------------------------------------D-----
XXXXXXXXXXXXXX----------------------------------------------------------------------------------DD--------D------------------------------------D------
XXXXXXXXXXXXXX---------------------------------------------D------------------------------------DD--------D-----------------------------------D-------
-------------X---------------------------------------------------------------------------o------DD--------D-------------------------------------------
-------------X------------------------------------------------------------o--------------o------DD--------D----------D----------------o-DDDD----------
-------------------------------------------------------TT-----------------D--------------o------DD--------D---------------------------D---------D-----
--------------------------------------------X----------tt-----------------D--------------D-XX---DD----XX--DDDDDDDDDDDD----------------DD--------D-----
-D-D-DD--D-D-DD---------------------TT-----XX------TToott-----o--------------o-------------XX---DD----XX-----------D---X--o---------------------D-----
-D-D-D-D-D-D-D---------------------otto-----X------ttoott-----o----------*---o----------*--D----------D---o--------D---X--o----------*----------------
-DD--DD--D-D-DD-D-----*-----D------otto-----X------ttoott-----o-------*--D---o-------*--D--D---------*D---*----------o-X--o-------*--D-------------F--
-D-D-D-D--D---D-D-----D-----D-X-X--otto--X-X-------ttggtt---------k---D--D------g--g-D--D--D*--oooo--D----D----r-----*-X------k---D--D-------------#--
-D-D-D-D--D--DDXXXXXXXXXXXXXXXXXXXXXXXXXXXXXXXXXXXXXXXXXXXXXXXXXXXXXXXXXXXXXXXXXXXXXXXXXXX--DDDDDDDDD----XXXXXXXXXXXXXXXXXXXXXXXXXXXXXXXXXXXXXXXXXXXXX
---------------XXXXXXXXXXXXXXXXXXXXXXXXXXXXXXXXXXXXXXXXXXXXXXXXXXXXXXXXXXXXXXXXXXXXXXXXXXX---------------XXXXXXXXXXXXXXXXXXXXXXXXXXXXXXXXXXXXXXXXXXXXX
