----------------------------------------------------------------------------------X-------DDDDDDD-----------------------------------------------------
----------------------------------------------------------------------------------X-------------D-----------------------------------------------------
----------------------------------------------------------------------------------X-------------D-----------------------------------------------------
----------------------------------------------------------------------------------X-------------D-----------------------------------------------o-----
--------------------------------------------------oo----------------------g-X------X------------D----------------------------------------------o------
---------------------------------------------------------oX-------------DDD-XX---XXXX----X-X--ooD---------------------------------------------o-------
---------------------------------------------------------oX-----------TTDD--XX---XXXXX--XX-X--ooD---------------------------------------------#-------
---------------------------------------------------------XX-----------tt----XX---XXXXX---X-X---o---------------------------------------------##-------
X------o--o-----------------------------------XXX----XX--XX-----g-g---tt----XX--oXXXXX---X-X---o--------o------------------------------------##-------
X------o--o---------------------------------X-XXX----XX--XX-XXXXXXXTTXXXXXX-XX--oXXXXXX--X-X------------D--------o------------------------o--##-------
X-----------------------------------TT-----XX---X---------X-XXXXXXXttXXXXXX-XX---o-------X-X---------------------o------------------------#--##-------
X------!--!-----------C-S-S-C------otto-----XX--X---------X--------tt-------XX---o-------X-X---------o-----------o-------------C-S-S-C---##--##-------
X----------------------------------otto-----XX--X---------X--------tt-------XX---XXX-XXXXX-X---------D-----------o-----------------------##--##----F--
X--M--------g-g-------ooo-----X-X--otto--X-X----X---------X--------tt-------XX----XX-XXXXX-X---------------------o-------------ooo-----#-##--##----#--
XXXXXXXXXXXXXXXXXXX--XXXXX-XXXXXXXXXXXXXXXXXXXXXX---------X--------tt-------XX----XX-XXXXX-X---DD--------X-------X-----XXXXX--XXXXX-XXXX-XX--XXXXXXXXX
XXXXXXXXXXXXXXXXXXX--XXXXX-XXXXXXXXXXXXXXXXXXXXXX---------X--------tt-------XX----XX-XXXXX-X-------------X-------X-----XXXXX--XXXXX-XXXX-XX--XXXXXXXXX
