-------------------------------------------------------------D------------D--------------------D----D--------------------D------------D---------------
-------------------------------------------------------------D------------D--------------------D----D--------------------D------------D---------------
-------------------------------------------------------------D------------D--------------------D----D--------------------D------------D---------------
---M---X--gX-g-----------------------------------------------D------------D--------------------D----D--------------------D------------D---------------
XXXXXXXXXXXXXX---------------------------------------------g-D------------D--------------------Do--oD-----------------YD-D------------D---------------
XXXXXXXXXXXXXX-------------------------------------------DDD-D------------D--------------------Do--oD----------------TTD-D------------D-------o-------
-------------X-----------------------------------------TTDD--D------------D--------------D-----------------------TT--ttD-D------------D-------#-------
-------------X-----------------------------------------tt----D------------D-------------YD---------------------y-tty-ttD-D------------D------##-------
----------------------------------oooo-----g-----g-g---tt----D------------D-------------DD---#y-#--#y-#---DDTTDDDttDDttD-D------------D----o-##-------
-----------------------------X##--####--#####XXXXXXXTTXXXXXX-D------------D--------------D#--####--####-----tt---tt--tt--D------------D----#-##-------
-D-D-DD--D-D-DD------TT-----XX-#-y#--#-y#----XXXXXXXttXXXXXX-DDDDDDDDDDDDD---------g-g-g-D------------------tt---tt--tt--DDDDDDDDDDDDD----##-##-------
-D-D-D-D-D-D-D------otto-----X--##----##------------tt------------oo-----------DDDDDDDDDDD------------------tt---tt--tt-------oo---------###-##-------
-DD--DD--D-D-DD-----otto-----X----------------------tt------------------------D----------D------------------tt---tt--tt----------------o-###-##----F--
-D-D-D-D--D---DX-X--otto--X-X-----------------------tt-------k--y----y-------D-----------D------------------tt---tt--tt--k--y----y-----#-###-##g--g#--
-D-D-D-D--D--DDXXXXXXXXXXXXXXX----------------------tt------XXXXXXXXXXXXXXXXXXXXXXXXXXXXXX------------------tt---tt--tt-XXXXXXXXXXXXXXXX-XXX-XXXXXXXXX
---------------XXXXXXXXXXXXXXX----------------------tt------XXXXXXXXXXXXXXXXXXXXXXXXXXXXXX------------------tt---tt--tt-XXXXXXXXXXXXXXXX-XXX-XXXXXXXXX
