----------------------------------------------------------------------------D------------D--------------------------------D---------D-----------------
----------------------------------------------------------------------------D------------D--------------------------------D---------D-----------------
--------!--!----------------------------------------------------------------D------------D---------------------------YYY--D---------D-----------------
----------------------------------------------------------------------------D------------D---------------------------DDD--D---------D-----------------
----------------------------------------------------------------------------D------------D-----------------------------D--D---------D-----------------
X-------!--!----------------------------------------------------------------D------------D-----------------------------D--D---------D---------o-------
X-------------------------------------------------------------------------D-D------------D---------------------------D-D--D---------D---------#-------
X--M---------------------------------------------------------------------YD-D------------D--------------o------------o-D--D---------D--------##-------
XXXXXoXXoXXoXX-----oooo-----g-----------------------D--------------------DD-D------------D--------------D----ooo-----o-D--D---------D------o-##-------
XXXXXXXXXXXXXX-##--####--#####-----------------SSS@SSSS---D---------------D-D------------D--------------D-DD-DDDD-DDDDDD--DDDDDDDDDDD------#-##-------
XXXXXXXXXXXX----#-y#--#-y#----------------------------S---D---------g-g-g-D-DDDDDDDDDDDDD---o---------------------------------------------##-##-------
XXXXXXXXX--------##----##------------------------------SSSD-----DDDDDDDDDDD------oo---------o----------*---------------------------------###-##-------
XXXXXX-------------------------D-----*-----D---oo-------ooD----D----------D-----------------o-------*--D----------------------ooo---oo-o-###-##----F--
XXX----------------------------D-----D-----D---oo--g----ooD---D-----------D-k--y----y-----------k---D--D-----------------------y--Y--y-#-###-##g--g#--
XX----------------------------XXXXXXXXXXXXXXXXXXXXXXXXXXXXXXXXXXXXXXXXXXXXXXXXXXXXXXXXXXXXXXXXXXXXXXXXXXX---------------XXXXXXXXXXXXXXXX-XXX-XXXXXXXXX
X-----------------------------XXXXXXXXXXXXXXXXXXXXXXXXXXXXXXXXXXXXXXXXXXXXXXXXXXXXXXXXXXXXXXXXXXXXXXXXXXX---------------XXXXXXXXXXXXXXXX-XXX-XXXXXXXXX
