----------------------------------------------------------------------------D------------D-D------------D-D-------------------------------------------
----------------------------------------------------------------------------D------------D-D------------D-D-------------------------------------o-----
-----------------------------#----------------------------------------------D------------D-D------------D-D-------------------------------------o-----
-----------------------------#----------------------------------------------D------------D-D------------D-D-------------------------------------D-----
----------------------------------------------------------------------------D------------D-D------------D-D------------------------------------D------
--------------------------#-------------------------------------------------D------------D-D------------D-D-----------------------------------D-------
o-------------------------#--------o--------------------------------------D-D------------D-D------------D-D------o------------------------------------
X-------------------------#-------Xo-------------------------------------YD-D------------D-D------------D-D-----o-o---------------------DDDD----------
X----------------------------#----Xo---------------o---------------------DD-D------------D-D------------D-D----o-o-o----------------------------D-----
X--------o-------------------#-XXXXXTTXXXXXX------o-o---------------------D-D------------D-D------------D-DDDDDDDDDDDDD---------------XD--------D-----
X--------o-------------------#-XXXXXttXXXXXX-----o-o-o--------------g-g-g-D-DDDDDDDDDDDDD--DDDDDDDDDDDDD----------------------TT-----XX---------D-----
X--------o------------oo----##------tt----------o-o-o-o---------DDDDDDDDDDD------oo-------------oo---------------------------otto-----X---------------
XX----------------#---##---###------tt-------D-----|-------D---D----------D------------------------------------TT------------otto-----X------------F--
XX-M-D--gD-gD-gX--#--y--y--###------tt-------X-k---|----k--X--D-----------D-k--y----y------k--y----y-----------tt-------X-X--otto--X-X-------------#--
XXXXXXXXXXXXXXXXXXXXXXXXXXXXXX------tt-------XXXXXXXXXXXXXXXXXXXXXXXXXXXXXXXXXXXXXXXXXXXXXXXXXXXXXXXXXXXX--TT--tt---TT--XXXXXXXXXXXXXXXXXXXXXXXXXXXXXX
XXXXXXXXXXXXXXXXXXXXXXXXXXXXXX------tt-------XXXXXXXXXXXXXXXXXXXXXXXXXXXXXXXXXXXXXXXXXXXXXXXXXXXXXXXXXXXXX-tt--tt---tt--XXXXXXXXXXXXXXXXXXXXXXXXXXXXXX
