-------------------------------------------------------D-----------------------------------D----------------------------------------------------------
-------------------------------------------------------D-----------------------------------D----------------------------------------------------o-----
-----------------------------#-------------------------D-----------------------------------D----------------------------------------------------o-----
-----------------------------#------------------#-----oD-----------------------------------D----------------------------------------------------D-----
----------------------------------------------###-----oD-----------------------------------D---------------------------------------------------D------
--------------------------#-----------------X-----#--y-------------------------------------D--------------------------------------------------D-------
o-------------------------#-----------------X-----#####------------------------------------D----------------------------------------------------------
X-------------------------#----------------XX----------------------------------------------D---------------------------D-------------o--DDDD----------
X----------------------------#-XXX--XXXXX-XXX---------#g-g-----------------------o---------DDDDDDDDDDD-------------------X-----------2X---------D-----
X--------o-------------------#-XXX--XXXXX-XXX---------######--------o-----------o-o------------------D----------o----D---X------------XD--------D-----
X--------o-------------------#-------------oX-----------------------o----------o-o-o-----------------D--Y-------o--------X-----------oX---------D-----
X--------o------------oo----##X------------oX-----------------------o---------o-o-o-o------------------oo-------o------D-X-----------2X---------------
XX----------------#---##---###X------------oX-----------------------o------D-----|-------D-------------oo-------o------D-X------------X------------F--
XX-M-D--gD-gD-gX--#--y--y--###--------g----oX-----------------------o------X-k---|----k--X---XyX-XyXyX-ooD------r------D-X-r-----r----X------------#--
XXXXXXXXXXXXXXXXXXXXXXXXXXXXXXXXXX--XXXXX-XXX---------------X-------X-----XXXXXXXXXXXXXXXXX--XXX-XXXXX-XXXXX----D----XXXXXXX--XX-XX-XXXXXXXXXXXXXXXXXX
XXXXXXXXXXXXXXXXXXXXXXXXXXXXXXXXXX--XXXXX-XXX---------------X-------X-----XXXXXXXXXXXXXXXXX--XXX-XXXXX-XXXXX---------XXXXXXX--XX-XX-XXXXXXXXXXXXXXXXXX
