---------------------------------------------------------------------------------------------------------DD-------------------------------------------
----------------------------------------------------------L-----------------------------------------------D-------------------------------------------
----------------------------------------------------------------------------------------------------------D-------------------------------------------
---------------------------------------------------------K------------------------------------------------D-------------------------------------o-----
------------------------------------------------------%%%%%-----------------------------------------------D------------------------------------o------
------------------------------------------------------%%%%%-----------------------------------------------D-----------------------------------o-------
--------------------------------------------o-----------||------------------------------------------------D-----------------------------------#-------
--------------------------------------------o---k---k---||----------------o-----------------------------D-D----------D-----------------------##-------
X------o--o---------------------------------o-%%%%%%%%%%%%%---------------D-------------------------------D----------------------------------##-------
X------o--o------------o--------------------D-%%%%%%%%%%%%%---------------D----------------------o----D---DDDDDDDDDDDD--------------------o--##-------
X----------------------o--------o-------------------||--------o----------------------------------o-----------------D---X-------o-----*D---#--##-------
X------!--!------------o--------o----------*--------||--------o----------*---2122222222X---------o------D-o--------D---X-------o----ooD--##--##-------
X----------------------o--------o-------*--D--------||--------o-------*--D-------ooooooX---------o------D-*----------o-Xo------o----DDD--##--##----F--
X--M--------g-g--------o-----------g--g-D--D--------||------------k---D--D---g--gooooooX--D------r------D-D----r-----*-Xo------g-----*D#-##--##----#--
XXXXXXXXXXXXXXXX-------X-----XXXXXXXXXXXXXXXX-------||------XXXXXXXXXXXXXXXXXXXXXXXXXXXXXXXXX----D----XXXXXXXXXXXXXXXXXXX------X-----XXX-XX--XXXXXXXXX
XXXXXXXXXXXXXXXX-------X-----XXXXXXXXXXXXXXXX-------||------XXXXXXXXXXXXXXXXXXXXXXXXXXXXXXXXX---------XXXXXXXXXXXXXXXXXXX------X-----XXX-XX--XXXXXXXXX
