-----------------------------------------------------------------------------------------------------------D---------D---D------------D---------------
-----------------------------------------------------------------------------------------------------------D---------D---D------------D---------------
--------!--!------------------------------------------------------------------------------------------YYY--D---------D---D------------D---------------
------------------------------------------------------------------------------------------------------DDD--D---------D---D------------D-------o--o----
--------------------------------------------------------------------------------------------------------D--D---------D---D------------D---------------
X-------!--!--------------------------------------------------------------------------------------------D--D---------D---D------------D---------------
X-----------------------------------------------------------------------------------------------------D-D--D---------D---D------------D-------#-------
X--M-------------------------------------------------------------------------------------o------------o-D--D---------D---D------------D-----g##-------
XXXXXoXXoXXoXX-----oooo-----g----------------------o--------------o----------------------D----ooo-----o-D--D---------D---D------------D-----###-------
XXXXXXXXXXXXXX-##--####--#####--------------------o-o------------o-o---------------------D-DD-DDDD-DDDDDD--DDDDDDDDDDD---D------------D---g####-------
XXXXXXXXXXXX----#-y#--#-y#-----------------------o-o-o----------o-o-o--------o-------------------------------------------DDDDDDDDDDDDD----#####-------
XXXXXXXXX--------##----##-----------------------o-o-o-o-----K--o-o-o-o--K----o----------*-------------------------------------oo--------g######-------
XXXXXX-------------------------D-----*-----D-D-----|-------DD---D---D---D----o-------*--D----------------------ooo---oo-----------------#######----F--
XXX----------------------------D-----D-----D-X-k---|----k--X--D---D---D----------k---D--D-----------------------y--Y--y--k--y----y-----########----#--
XX----------------------------XXXXXXXXXXXXXXXXXXXXXXXXXXXXXXXXXXXXXXXXXXXXXXXXXXXXXXXXXXXX---------------XXXXXXXXXXXXXXXXXXXXXXXXXXXXXXXXXXXXXXXXXXXXX
X-----------------------------XXXXXXXXXXXXXXXXXXXXXXXXXXXXXXXXXXXXXXXXXXXXXXXXXXXXXXXXXXXX---------------XXXXXXXXXXXXXXXXXXXXXXXXXXXXXXXXXXXXXXXXXXXXX
