-------------------------------D----------------------D------------------------------------D-------------DD-------------------------------------------
-------------------------------D----------------------D------------------------------------D--------------D-------------------------------------o-----
--------!--!-------------------D----------------------D------------------------------------D--------------D-------------------------------------o-----
-------------------------------D------------D-DDTT------k-k--------------------------------D--------------D-------------------------------------D-----
-------------------------------D*-----------D-DDtt--TT-DDDDD--------------g----------------D--------------D------------------------------------D------
X-------!--!-------------------DD----------DD---tt--tt------------------DDD----------------D--------------D-----------------------------------D-------
X-------------------o----------D---------D--D---tt--tt----------------TTDD-----------------D------o-------D-------------------------------------------
X--M---------------Xo-----------------------D---tt--tt----------------tt-------------------D-----o-o------D----------D------------------DDDD----------
XXXXXoXXoXXoXX-----Xo-------------k----k----D---tt--tt----------g-g---tt---------o---------D----o-o-o-----D-------------------------------------D-----
XXXXXXXXXXXXXX--XXXXXTTXXXXXX--XXXXXXXXXXXXXX---tt--tt------XXXXXXXTTXXXXXX-----o-o--------DDDDDDDDDDDDD--DDDDDDDDDDDD----------------XD--------D-----
XXXXXXXXXXXX----XXXXXttXXXXXX--XXXXXXXXXXXXXX---tt--tt------XXXXXXXttXXXXXX----o-o-o-------------------------------D---X------TT-----XX---------D-----
XXXXXXXXX------------tt-------------------------tt--tt-------------tt------K--o-o-o-o--K------------------o--------D---X-----otto-----X---------------
XXXXXX---------------tt-------------------------tt--tt-------------tt------D---D---D---D--------TT--------*----------o-X-----otto-----X------------F--
XXX------------------tt-------------------------tt--tt-------------tt--------D---D---D----------tt--------D----r-----*-XX-X--otto--X-X-------------#--
XX-------------------tt-------------------------tt--tt-------------tt------XXXXXXXXXXXXXXX--TT--tt---TT--XXXXXXXXXXXXXXXXXXXXXXXXXXXXXXXXXXXXXXXXXXXXX
X--------------------tt-------------------------tt--tt-------------tt------XXXXXXXXXXXXXXXX-tt--tt---tt--XXXXXXXXXXXXXXXXXXXXXXXXXXXXXXXXXXXXXXXXXXXXX
