-------------------------------------------------------------D--------------D------------D-D--------------D-------------------------------------------
-------------------------------------------------------------D--------------D------------D-D--------------D-------------------------------------o-----
--------------------------------------------#----------------D--------------D------------D-D--------------D---------------------------#---------o-----
--------------------------------------------#----------------D------------D-D------------D-D--------------D---------------------------#---------D-----
-------------------------------------------------------------D*-----------D-D------------D-D--------------D------------------------------------D------
-----------------------------------------#-------------------DD----------DD-D------------D-D--------------D-----o------------------#----------D-------
o----------------------------------------#-----------------o-D---------D--D-D*-----------D-D--------------D----o-o-----------------#------------------
X----------------------------o-----------#-----------------o--------------D--------------D-D--------------D---o-o-o--D-------------#----DDDD----------
X----------------------------D--------------#--------------o----k----k----D-X*-----------D-DDDDDDDDDDDDDD-DDDDDDDDDDDDo---------------#---------D-----
X--------o-------------------D--------------#--------------D-XXXXXXXXXXXXXX-XX*------k---D-------------D--------------oD--------------#D--------D-----
X--------o-------o--------------------------#--o-------------XXXXXXXXXXXXXX-XXXXXXXXXXXXo--------------*-X------------oD--------------#---------D-----
X--------o-------o----------*--------oo----##--o----------*----------------------------Xo----------------X*-----------DD-------oo----##---------------
XX---------------o-------*--D----#---##---###--o-------*--D----------------------------Xo-Xoooooooooooo*XX*------------X---#---##---###------------F--
XX-M-D--gD-gD-g------k---D--D-X--#--y--y--###-----g--g-D--D----------------------------Xo-X---y--y--y---XX---y-----y---XX--#--y--y--###------------#--
XXXXXXXXXXXXXXXXXXXXXXXXXXXXXXXXXXXXXXXXXXXXXXXXXXXXXXXXXXXX---------------------------XXXXXXXXXXXXXXXXXXXXXXXXXXXXXXXXXXXXXXXXXXXXXXXXXXXXXXXXXXXXXXX
XXXXXXXXXXXXXXXXXXXXXXXXXXXXXXXXXXXXXXXXXXXXXXXXXXXXXXXXXXXX---------------------------XXXXXXXXXXXXXXXXXXXXXXXXXXXXXXXXXXXXXXXXXXXXXXXXXXXXXXXXXXXXXXX
