--------------------------------------------------------------------------------------------D---------D---D--------------D------------D---------------
--------------------------------------------------------------------------------------------D---------D---D--------------D------------D---------------
-----------------------------#--------------------------------------------------------------D---------D---D--------------D------------D---------------
---M---X--gX-g---------------#------------------------------------------G-------------------D---------D---D--------------D------------D---------o-----
XXXXXXXXXXXXXX---------------------------------------------g-DDD--------DD------------------D---------D---D--------------D------------D--------o------
XXXXXXXXXXXXXX------------#------------------------------DDD-DDD--------DD------------------D---------D---D--------------D------------D-------o-------
-------------X------------#----------------------------TTDD----D--------D-------------------D---------D---D------o-------D------------D-------#-------
-------------X------------#----------------------------tt---D---Dg----gD--D-----------------D---------D---D-----o-o------D------------D------##-------
-----------------------------#-------------------g-g---tt--------D----D---------------------D---------D---D----o-o-o-----D------------D------##-------
-----------------------------#--------------XXXXXXXXTTXXXXXX------DooD-------------------X--DDDDDDDDDDD---DDDDDDDDDDDDD--D------------D---o--##-------
-D-D-DD--D-D-DD--------------#------TT-----XXXXXXXXXttXXXXXX------DooD-----------TT-----XX-------------------------------DDDDDDDDDDDDD----#--##-------
-D-D-D-D-D-D-D--------oo----##-----otto-----X-------tt------------DooD----------otto-----X------------------------------------oo---------##--##-------
-DD--DD--D-D-DD---#---##---###-----otto-----X-------tt-------------DD-----------otto-----X------ooo---oo-------TT------------------------##--##----F--
-D-D-D-D--D---DX--#--y--y--###X-X--otto--X-X--------tt---------------------X-X--otto--X-X--------y--Y--y-------tt--------k--y----y-----#-##--##----#--
-D-D-D-D--D--DDXXXXXXXXXXXXXXXXXXXXXXXXXXXXXX-------tt---------------------XXXXXXXXXXXXXXXXXXXXXXXXXXXXXX--TT--tt---TT--XXXXXXXXXXXXXXXX-XX--XXXXXXXXX
---------------XXXXXXXXXXXXXXXXXXXXXXXXXXXXXX-------tt---------------------XXXXXXXXXXXXXXXXXXXXXXXXXXXXXXX-tt--tt---tt--XXXXXXXXXXXXXXXX-XX--XXXXXXXXX
