----------------------------------------------------------------------------------------------D--*---D----D-------------------------------------------
----------------------------------------------------------------------------------------------D-*-*--D----D-------------------------------------------
----------------------------------------------------------------------------------------------D*-*-*-D----D-------------------------------------------
---M---X--gX-g--------------------------------------------------------------------------------DDDDDDDD----D-------------------------------------------
XXXXXXXXXXXXXX---------------------------------------------------------------------------gDD------------D-D-------------------------------------------
XXXXXXXXXXXXXX---------------------------------------------D---------------------------DDD--------------D-D-----------------------------------o-------
-------------X-----------------------------------------------------------------------TTDD-D*-oo----oo---D-D------o----------------------------#-------
-------------X------------------------------------------------------------o----------tt-----------------D-D-----o-o--------------------------##-------
-------------------------------------------------------TT-----------------D----g-g---tt---D*-----------DD-D----o-o-o-----------------------o-##-------
--------------------------------------------X----------tt-----------------DXXXXXXXTTXXXXXX---oo----oo---D-DDDDDDDDDDDDD---------------X----#-##-------
-D-D-DD--D-D-DD---------------------TT-----XX------TToott-----o------------XXXXXXXttXXXXXXD*------------D---------------------TT-----XX---##-##-------
-D-D-D-D-D-D-D---------------------otto-----X------ttoott-----o----------*--------tt-------------------DD--------------------otto-----X--###-##-------
-DD--DD--D-D-DD-D-----*-----D------otto-----X------ttoott-----o-------*--D--------tt---------TT----TT----------TT------------otto-----Xo-###-##----F--
-D-D-D-D--D---D-D-----D-----D-X-X--otto--X-X-------ttggtt---------k---D--D--------tt---------tt-D--tt----------tt-------X-X--otto--X-X-#-###-##g--g#--
-D-D-D-D--D--DDXXXXXXXXXXXXXXXXXXXXXXXXXXXXXXXXXXXXXXXXXXXXXXXXXXXXXXXXXXXX-------tt---------tt-D--tt------TT--tt---TT--XXXXXXXXXXXXXXXX-XXX-XXXXXXXXX
---------------XXXXXXXXXXXXXXXXXXXXXXXXXXXXXXXXXXXXXXXXXXXXXXXXXXXXXXXXXXXX-------tt---------tt-D--tt----X-tt--tt---tt--XXXXXXXXXXXXXXXX-XXX-XXXXXXXXX
