------------------------------------------------------------------------------------------DD-------------------DD--------D------------D---------------
-------------------------------------------------------------------------------------------D-------------------DD--------D------------D---------------
-------------------------------------------------------------------------------------------D-------------------DD--------D------------D---------------
-------------------------------------------------------------------------------------------D-------------------DD--------D------------D---------o-----
--------------------------------------------------------------------------------oo---------D-------------------DD--------D------------D--------o------
---------------------------------------------------------------------------------------oX--D-------------------DD--------D------------D-------o-------
-----------------------------------------------------------o---------------------------oX--D-------------------DD--------D*-----------D-------#-------
-----------------------------------------------------------o--------------D------------XX--D----------D--------DD---------------------D------##-------
X------o--o------------------------------------------------o----------------XXX----XX--XX--D-------------------DD--------X*-----------D------##-------
X------o--o------------------------------------------------D-------o----D---XXX----XX--XX--DDDDDDDDDDDD---XX---DD----XX--XX*------k---D---o--##-------
X----------------------------------------------o-------------------o----------X---------X-----------D---X-XX---DD----XX--XXXXXXXXXXXXo----#--##-------
X------!--!--------------------------C-S-S-C---o----------*--------o------DX--X---------X--o--------D---X-D----------D--------------Xo---##--##-------
X---------------D-----*-----D------------------o-------*--D--------o------DX--X---------X--*----------o-X-D---------*D--------------Xo---##--##----F--
X--M--------g-g-D-----D-----D--------ooo----------g--g-D--D-D------r------D---X---------X--D----r-----*-X-D*--oooo--D---------------Xo-#-##--##----#--
XXXXXXXXXXXXXXXXXXXXXXXXXXXXXXXXXX--XXXXX-XXXXXXXXXXXXXXXXXXXXX----D----XXXXXXX---------X-XXXXXXXXXXXXXXX--DDDDDDDDD----------------XXXX-XX--XXXXXXXXX
XXXXXXXXXXXXXXXXXXXXXXXXXXXXXXXXXX--XXXXX-XXXXXXXXXXXXXXXXXXXXX---------XXXXXXX---------X-XXXXXXXXXXXXXXX---------------------------XXXX-XX--XXXXXXXXX
