--------------------------------------------------------------------------------------------------------D---------------------DD----------------------
--------------------------------------------------------------------------------------------------------D---------------------DD----------------o-----
--------------------------------------------------------------------------------------------------------D---------------------DD----------------o-----
--------------------------------------------------------------------------------------------------------D---------------------DD----------------D-----
--------------------------------------------------------------------------------------------------------D---------------------DD---------------D------
-------------------------------------------------------------------------------------------oo-----------D---------------------DD--------------D-------
--------------------------------------------------------------------------o-----------------------------D---------------------DD----------------------
-----------------------------------------------------------o--------------o--------------D--------------D--------------o------DD--------DDDD----------
X------o--o------------------------------------------------D--------------o----------------DD--oo----------------------D------DD----------------D-----
X------o--o------------o-----------------------------------D--------------D-------o----D---D*--------------------------D-XX---DD----XX-D--------D-----
X----------------------o-----------------------o--------------o-------------------o--------D*----------o---o-------------XX---DD----XX----------D-----
X------!--!------------o-----------------------o----------*---o----------*--------o------D-D----g------o---o----------*--D----------D-----------------
X----------------------o-------D-----*-----D---o-------*--D---o-------*--D--------o------D-D---DD------o---o-------*--D--D---------*D--------------F--
X--M--------g-g--------o-------D-----D-----D-------k---D--D------g--g-D--D-D------r------D-D*----------g-------k---D--D--D*--oooo--D---------------#--
XXXXXXXXXXXXXXXX-------X-----XXXXXXXXXXXXXXXXXXXXXXXXXXXXXXXXXXXXXXXXXXXXXXXXX----D----XXX-D----------DD-XXXXXXXXXXXXXXX--DDDDDDDDD----XXXXXXXXXXXXXXX
XXXXXXXXXXXXXXXX-------X-----XXXXXXXXXXXXXXXXXXXXXXXXXXXXXXXXXXXXXXXXXXXXXXXXX---------XXX-D-------------XXXXXXXXXXXXXXX---------------XXXXXXXXXXXXXXX
