---------------------------------------------------------------------------------------------------------DD---------------------------D---------------
----------------------------------------------------------------------------------------------------------D---------------------------D---------------
--------!--!----------------------------------------------------------------------------------------------D---------------------------D---------------
----------------------------------------------------------------------------------------------------------D---------------------------D---------o-----
-----------------------------------------------------------------oo---------------------------------------D---------------------------D--------o------
--------!--!------------------------------------------------------------oX--------------------------------D--------------oo-----------D-------o-------
------------------------------------------------------------------------oX---------------o----------------D---------------------------D-------#-------
---M---------k---------------------------------------------D------------XX---------------o----------------D----------D----------------D------##-------
XXXXXXXXXXXXXX-----------------------------------------------XXX----XX--XX---------------o----------------D--------------DD--oo--------------##-------
XXXXXXXXXXXXXX--------------------------------------o----D---XXX----XX--XX---------------D--------o-------DDDDDDDDDDDD---D*---------------o--##-------
----------------------------------------------------o----------X---------X---o--------------------o----------------D---X-D*----------o----#--##-------
-------------------------------------C-S-S-C--------o------DX--X---------X---o----------*---------o-------o--------D---X-D----g------o---##--##-------
----------------D-----*-----D-----------------------o------DX--X---------X---o-------*--D---------o-------*----------o-X-D---DD------o---##--##----F--
----------------D-----D-----D--------ooo-----D------r------D---X---------X------g--g-D--D---------o-------D----r-----*-X-D*----------g-#-##--##----#--
---------------XXXXXXXXXXXXXXXXXXX--XXXXX-XXXXXX----D----XXXXXXX---------X-XXXXXXXXXXXXXXXX-------X-----XXXXXXXXXXXXXXXX-D----------DD-X-XX--XXXXXXXXX
---------------XXXXXXXXXXXXXXXXXXX--XXXXX-XXXXXX---------XXXXXXX---------X-XXXXXXXXXXXXXXXX-------X-----XXXXXXXXXXXXXXXX-D-------------X-XX--XXXXXXXXX
