----------------------------------------------D------------D----------------------------------------------D-------------------------------------------
----------------------------------------------D------------D----------------------------------------------D-------------------------------------------
-----------------------------#----------------D------------D----------------------------------------------D-------------------------------------------
-----------------------------#----------------D------------D----------------------------------------------D-------------------------------------o-----
----------------------------------------------D------------D--------------------oo------------------------D------------------------------------o------
--------------------------#-------------------D------------D---------------------------oX-----------------D-----------------------------------o-------
--------------------------#-------------------D------------D--------------D------------oX-----------------D---------------------------D-------#-------
--------------------------#-------------------D------------D-------------YD------------XX-----------------D--------------------------YD------##-------
X------o--o------------------#----------------D------------D-------------DD-XXX----XX--XX-----------------DDDDDDDDDDD----------------DD------##-------
X------o--o------------------#----------------D------------D--------------D-XXX----XX--XX---------o-----------------------------------D---o--##-------
X----------------------------#----------------DDDDDDDDDDDDD---------g-g-g-D---X---------X---------o-----------------------------g-g-g-D---#--##-------
X------!--!-----------oo----##-------C-S-S-C-------oo-----------DDDDDDDDDDDX--X---------X---------o-----------o--------Y----DDDDDDDDDDD--##--##-------
X-----------------#---##---###---------------------------------D----------DX--X---------X---------o-----------o--------Y---D----------D--##--##----F--
X--M--------g-gX--#--y--y--###-------ooo------k--y----y-------D-----------D---X---------X---------o-----------o-----Dy-D--D-----------D#-##--##----#--
XXXXXXXXXXXXXXXXXXXXXXXXXXXXXXXXXX--XXXXX-XXXXXXXXXXXXXXXXXXXXXXXXXXXXXXXXXXXXX---------X-X-------X-----XX----X-----XXXXXXXXXXXXXXXXXXXX-XX--XXXXXXXXX
XXXXXXXXXXXXXXXXXXXXXXXXXXXXXXXXXX--XXXXX-XXXXXXXXXXXXXXXXXXXXXXXXXXXXXXXXXXXXX---------X-X-------X-----XX----X-----XXXXXXXXXXXXXXXXXXXX-XX--XXXXXXXXX
