-------------------------------D--------------------------------------------D------------D-D------------D-D------------DDD----------------------------
-------------------------------D--------------------------------------------D------------D-D------------D-D------------D-D----------------------------
-----------------------------#-D--------------------------------------------D------------D-D------------D-D------------D-D----------------------------
-----------------------------#-D------------D-------------------------------D------------D-D------------D-D------------D-D----------------------------
-------------------------------D*-----------D-------------------------------D------------D-D------------D-D------------D-D----------------------------
--------------------------#----DD----------DD-------------------------------D------------D-D------------D-D------------D-D--------------------o-------
--------------------------#----D---------D--D-----------------------------D-D------------D-D------------D-D------------D-D--------------------#-------
--------------------------#-----------------D--------------o-------------YD-D------------D-D------------D-D------------D-D----------D--------##-------
X------o--o------------------#----k----k----D--------------D-------------DD-D------------D-D------------D-D------------D-D-----------------o-##-------
X------o--o------------------#-XXXXXXXXXXXXXX--------------D--------------D-D------------D-D------------D-D------------D-DDDDDDDDDDDD------#-##-------
X----------------------------#-XXXXXXXXXXXXXX--o--------------------g-g-g-D-DDDDDDDDDDDDD--DDDDDDDDDDDDD--DDDDDDDDDDDDD-----------D---X---##-##-------
X------!--!-----------oo----##-----------------o----------*-----DDDDDDDDDDD------oo-------------oo-------------oo--------o--------D---X--###-##-------
X-----------------#---##---###-----------------o-------*--D----D----------D----------------------------------------------*----------o-Xo-###-##----F--
X--M--------g-gX--#--y--y--###---------------------k---D--D---D-----------D-k--y----y------k--y----y------k--y----y------D----r-----*-X#-###-##g--g#--
XXXXXXXXXXXXXXXXXXXXXXXXXXXXXX---------------XXXXXXXXXXXXXXXXXXXXXXXXXXXXXXXXXXXXXXXXXXXXXXXXXXXXXXXXXXXXXXXXXXXXXXXXXXXXXXXXXXXXXXXXXXX-XXX-XXXXXXXXX
XXXXXXXXXXXXXXXXXXXXXXXXXXXXXX---------------XXXXXXXXXXXXXXXXXXXXXXXXXXXXXXXXXXXXXXXXXXXXXXXXXXXXXXXXXXXXXXXXXXXXXXXXXXXXXXXXXXXXXXXXXXX-XXX-XXXXXXXXX
