----------------------------------------------------------------------------D------------D--------------------D----D------D---------D-----------------
----------------------------------------------------------------------------D------------D--------------------D----D------D---------D-----------------
--------------------------------------------#-------------------------------D------------D--------------------D----D------D---------D-----------------
--------------------------------------------#-------------------------------D------------D--------------------D----D------D---------D---------o--o----
--------------------------------------------------oo------------------------D------------D--------------------Do--oD------D---------D-----------------
-----------------------------------------#---------------oX-----------------D------------D--------------------Do--oD------D---------D-----------------
-----------------------------------------#---------------oX---------------D-D------------D--------------D-----------------D---------D---------#-------
-----------------------------------------#---------------XX--------------YD-D------------D-------------YD-----------------D---------D-------g##-------
X------o--o---------------------------------#-XXX----XX--XX--------------DD-D------------D-------------DD---#y-#--#y-#----D---------D-------###-------
X------o--o---------------------------------#-XXX----XX--XX---------------D-D------------D--------------D#--####--####----DDDDDDDDDDD-----g####-------
X-------------------------------------------#---X---------X---------g-g-g-D-DDDDDDDDDDDDD---------g-g-g-D---------------------------------#####-------
X------!--!-----------C-S-S-C--------oo----##X--X---------X-----DDDDDDDDDDD------oo-----------DDDDDDDDDDD-------------------------------g######-------
X--------------------------------#---##---###X--X---------X----D----------D------------------D----------D---------------------ooo---oo--#######----F--
X--M--------g-g-------ooo-----X--#--y--y--###---X---------X---D-----------D-k--y----y-------D-----------D----------------------y--Y--y-########----#--
XXXXXXXXXXXXXXXXXXX--XXXXX-XXXXXXXXXXXXXXXXXXXXXX---------X-XXXXXXXXXXXXXXXXXXXXXXXXXXXXXXXXXXXXXXXXXXXXX---------------XXXXXXXXXXXXXXXXXXXXXXXXXXXXXX
XXXXXXXXXXXXXXXXXXX--XXXXX-XXXXXXXXXXXXXXXXXXXXXX---------X-XXXXXXXXXXXXXXXXXXXXXXXXXXXXXXXXXXXXXXXXXXXXX---------------XXXXXXXXXXXXXXXXXXXXXXXXXXXXXX
