------------------------------------------------------------------------------------------------------------------------------------------------------
------------------------------------------------------------------------------------------------------------------------------------------------------
--------!--!------------------------------------------------------------------------------------------------------------------------------------------
----------------------------------------------------------------------------------------------------------------------D-------------------------o-----
-----------------------------------------------------------g---------------------------------------------------------DD------------------------o------
X-------!--!---------------------------------------------DDD----------------------------------------------o-------oo--D-----------------------o-------
X------------------------------------------------------TTDD-----------------------------------------------o-------TT--D-----------------------#-------
X--M---------------------------------------------------tt--------------------------------D--------------D-o-------tt--D----------------------##-------
XXXXXoXXoXXoXX-----------------------------------g-g---tt----------D--------------------------------------o--oo-------D----------------------##-------
XXXXXXXXXXXXXX------------------------------XXXXXXXXTTXXXXXX--SSS@SSSS---D--------o----D---------o----D---o--TT-------D---------o---------o--##-------
XXXXXXXXXXXX------------------------TT-----XXXXXXXXXttXXXXXX---------S---D--------o--------------o--------o--tt---oo--D---------o---------#--##-------
XXXXXXXXX-------------C-S-S-C------otto-----X-------tt----------------SSSD--------o------D-------o------D-o-------TT--D---------o--------##--##-------
XXXXXX-----------------------------otto-----X-------tt--------oo-------ooD--------o------D-------o------D---------tt--D---------o--------##--##----F--
XXX-------------------ooo-----X-X--otto--X-X--------tt--------oo--g----ooD-D------r------DD------r------D-----g---tt--D---------o------#-##--##----#--
XX-------------XXXX--XXXXX-XXXXXXXXXXXXXXXXXX-------tt------XXXXXXXXXXXXXXXXXX----D----XXXXXX----D----XXXX---XX-X--XX-XXX-------X-----XX-XX--XXXXXXXXX
X--------------XXXX--XXXXX-XXXXXXXXXXXXXXXXXX-------tt------XXXXXXXXXXXXXXXXXX---------XXXXXX---------XXXX---XX-X--XX-XXX-------X-----XX-XX--XXXXXXXXX
