----------------------------------------------------------------------------------------------------------D--------------D----------------------------
----------------------------------------------------------------------------------------------------------D--------------D----------------------------
--------------------------------------------#-------------------------------------------------------------D--------------D----------------------------
--------------------------------------------#-------------------------------------------------------------D--------------D--------------------o--o----
----------------------------------------------------------------------------------------------------------D--------------D----------------------------
-----------------------------------------#----------------------------------------------------------------D--------------D----------------------------
-----------------------------------------#-----------------D----------------------------------------------D--------------D--------------------#-------
-----------------------------------------#----------------YD----------------------------------------------D--------------D------------------g##-------
X------o--o---------------------------------#-------------DD-------D--------------------------------------DDDDDDDDDDD----DDDDDDDDDDD--------###-------
X------o--o---------------------------------#--------------D--SSS@SSSS---D------------------------o--------------------------------D------g####-------
X-------------------------------------------#--------g-g-g-D---------S---D------------------------o--------------------------------D--Y---#####-------
X------!--!-----------C-S-S-C--------oo----##----DDDDDDDDDDD----------SSSD---2122222222X----------o-----------o--------Y-------------oo-g######-------
X--------------------------------#---##---###---D----------D--oo-------ooD-------ooooooX----------o-----------o--------Y-------------oo-#######----F--
X--M--------g-g-------ooo-----X--#--y--y--###--D-----------D--oo--g----ooD---g--gooooooX----------o-----------o-----Dy-D---XyX-XyXyX-oo########----#--
XXXXXXXXXXXXXXXXXXX--XXXXX-XXXXXXXXXXXXXXXXXXXXXXXXXXXXXXXXXXXXXXXXXXXXXXXXXXXXXXXXXXXXXXXX-------X-----XX----X-----XXXXX--XXX-XXXXX-XXXXXXXXXXXXXXXXX
XXXXXXXXXXXXXXXXXXX--XXXXX-XXXXXXXXXXXXXXXXXXXXXXXXXXXXXXXXXXXXXXXXXXXXXXXXXXXXXXXXXXXXXXXX-------X-----XX----X-----XXXXX--XXX-XXXXX-XXXXXXXXXXXXXXXXX
