-------------------------------------------------------D---------------------------------------D----D----------DD--------D----------------------------
-------------------------------------------------------D---------------------------------------D----D----------DD--------D----------------------------
--------------------------------------------#----------D---------------------------------------D----D----------DD--------D----------------------------
--------------------------------------------#---#-----oD---------------------------------------D----D----------DD--------D----------------------o-----
----------------------------------------------###-----oD---------------------------------------Do--oD----------DD--------D---------------------o------
-----------------------------------------#--------#--y-----------------------------------------Do--oD----------DD--------D--------------------o-------
-----------------------------------------#--------#####----------------------------------o---------------------DD--------D--------------------#-------
-----------------------------------------#-----------------------------------------------o---------------------DD--------D-------------------##-------
X------o--o---------------------------------#---------#g-g--------o----------------------o---#y-#--#y-#--------DD--------DDDDDDDDDDDDDD------##-------
X------o--o---------------------------------#---------######-----o-o---------------------D#--####--####---XX---DD----XX--------------D----o--##-------
X-------------------------------------------#-------------------o-o-o--------o----------------------------XX---DD----XX--------------*----#--##-------
X------!--!--------------------------oo----##------------------o-o-o-o-------o----------*-----------------D----------D-------------------##--##-------
X---------------D-----*-----D----#---##---###---------------D-----|-------D--o-------*--D-----------------D---------*D--Xoooooooooooo*X--##--##----F--
X--M--------g-g-D-----D-----D-X--#--y--y--###---------------X-k---|----k--X-----g--g-D--D-----------------D*--oooo--D---X---y--y--y---X#-##--##----#--
XXXXXXXXXXXXXXXXXXXXXXXXXXXXXXXXXXXXXXXXXXXXX---------------XXXXXXXXXXXXXXXXXXXXXXXXXXXXXX-----------------DDDDDDDDD----XXXXXXXXXXXXXXXX-XX--XXXXXXXXX
XXXXXXXXXXXXXXXXXXXXXXXXXXXXXXXXXXXXXXXXXXXXX---------------XXXXXXXXXXXXXXXXXXXXXXXXXXXXXX------------------------------XXXXXXXXXXXXXXXX-XX--XXXXXXXXX
