-----------------------------------------------------------------------------------------------------------D---------D---D----------------------------
-----------------------------------------------------------------------------------------------------------D---------D---D----------------------------
--------!--!-----------------#-----------------------------------------------------------------------------D---------D---D----------------------------
-----------------------------#-----------------------------------------------------------------------------D---------D---D----------------------o-----
-----------------------------------------------------------------------------------------------------------D---------D---D---------------------o------
X-------!--!--------------#--------------------------------------------------------------------------------D---------D---D--------------------o-------
X-------------------------#--------------------------------D-----------------------------------------------D---------D---D--------------------#-------
X--M----------------------#-------------------------------YD-----------------------------D-------------o---D---------D---D-------------------##-------
XXXXXoXXoXXoXX---------------#----------------------------DD-------------------------------X-----------2X--D---------D---DDDDDDDDDDD---------##-------
XXXXXXXXXXXXXX---------------#-----------------------------D----------------------o----D---X------------X--DDDDDDDDDDD-------------D------o--##-------
XXXXXXXXXXXX-----------------#-----------------------g-g-g-D----------------------o--------X-----------oX--------------------------D--Y---#--##-------
XXXXXXXXX-------------oo----##-------C-S-S-C-----DDDDDDDDDDD--2122222222X---------o------D-X-----------2X----------------------------oo--##--##-------
XXXXXX------------#---##---###------------------D----------D------ooooooX---------o------D-X------------X------ooo---oo--------------oo--##--##----F--
XXX------------X--#--y--y--###-------ooo-------D-----------D--g--gooooooX--D------r------D-X-r-----r----X-------y--Y--y----XyX-XyXyX-oo#-##--##----#--
XX-------------XXXXXXXXXXXXXXXXXXX--XXXXX-XXXXXXXXXXXXXXXXXXXXXXXXXXXXXXXXXXXX----D----XXXXXXX--XX-XX-XXXXXXXXXXXXXXXXXXX--XXX-XXXXX-XXX-XX--XXXXXXXXX
X--------------XXXXXXXXXXXXXXXXXXX--XXXXX-XXXXXXXXXXXXXXXXXXXXXXXXXXXXXXXXXXXX---------XXXXXXX--XX-XX-XXXXXXXXXXXXXXXXXXX--XXX-XXXXX-XXX-XX--XXXXXXXXX
