---------------------------------------------------------------------------------------------------------DDDDDDD--------------------------------------
---------------------------------------------------------------------------------------------------------------D--------------------------------------
--------!--!--------------------------------#---------------------------------------------------------YYY------D--------------------------------------
--------------------------------------------#------------G--------------------------------------------DDD------D--------------------------------o-----
----------------------------------------------DDD--------DD---------------------------------------------D------D-------------------------------o------
--------!--!-----------------------------#----DDD--------DD---------------------------------------------D-X--ooD------------------------------o-------
-----------------------------------------#------D--------D--------------------------------------------D-D-X--ooD------------------------------#-------
---M---------k---------------------------#---D---Dg----gD--D-----------------------------D------------o-D-X---o----------------------o-------##-------
XXXXXXXXXXXXXX------------------------------#-----D----D-----------D--------------------------ooo-----o-D-X---o--------o-X-----------2X------##-------
XXXXXXXXXXXXXX------------------------------#------DooD-------SSS@SSSS---D--------o----D---DD-DDDD-DDDDDD-X------------D-X------------X---o--##-------
--------------------------------------------#------DooD--------------S---D--------o-----------------------X--------------X-----------oX---#--##-------
----------------------C-S-S-C--------oo----##------DooD---------------SSSD--------o------D----------------X---------o----X-----------2X--##--##-------
---------------------------------#---##---###-------DD--------oo-------ooD--------o------D----------------X---------D----X------------X--##--##----F--
----------------------ooo-----X--#--y--y--###-----------------oo--g----ooD-D------r------D----------------X--------------X-r-----r----X#-##--##----#--
---------------XXXX--XXXXX-XXXXXXXXXXXXXXXXXX---------------XXXXXXXXXXXXXXXXXX----D----XXX----------------X---DD--------XXXX--XX-XX-XXXX-XX--XXXXXXXXX
---------------XXXX--XXXXX-XXXXXXXXXXXXXXXXXX---------------XXXXXXXXXXXXXXXXXX---------XXX----------------X-------------XXXX--XX-XX-XXXX-XX--XXXXXXXXX
