-------------------------------------------------------------------------------------D----------------------------------------------------------------
-------------------------------------------------------------------------------------D----------------------------------------------------------------
--------!--!-----------------#-------------------------------------------------------D----------------------------------------------------------------
-----------------------------#------------------------------------------------#-----oD----------------------------------------------------------o-----
--------------------------------------------------------------------------g-###-----oD---------------------------------------------------------o------
--------!--!--------------#--------------------------------D------------DDD-----#--y--------------------D-----------------------------D-------o-------
--------------------------#--------o----------------------------------TTDD------#####---------------------------------------------------------#-------
---M---------k------------#-------Xo----------------------------------tt---------------------------------------------------------------------##-------
XXXXXXXXXXXXXX---------------#----Xo-------------------TT-------g-g---tt------------#g-g------------TT----------------------------TT---------##-------
XXXXXXXXXXXXXX---------------#-XXXXXTTXXXXXX-----------tt---XXXXXXXTTXXXXXX---------######----------tt----------------------------tt------o--##-------
-----------------------------#-XXXXXttXXXXXX-------TToott---XXXXXXXttXXXXXX---------------------TToott------------------------TToott------#--##-------
----------------------oo----##------tt-------------ttoott----------tt---------------------------ttoott------------------------ttoott-----##--##-------
------------------#---##---###------tt-------------ttoott----------tt---------------------------ttoott------------------------ttoott-----##--##----F--
---------------X--#--y--y--###------tt-------------ttggtt----------tt---------------------------ttggtt------------------------ttggtt---#-##--##----#--
---------------XXXXXXXXXXXXXXX------tt-------XXXXXXXXXXXXXXX-------tt---------------------XXXXXXXXXXXXXXX----D--y---D---XXXXXXXXXXXXXXXX-XX--XXXXXXXXX
---------------XXXXXXXXXXXXXXX------tt-------XXXXXXXXXXXXXXX-------tt---------------------XXXXXXXXXXXXXXXXX---TTXXTT--XXXXXXXXXXXXXXXXXX-XX--XXXXXXXXX
