------------------------------------------------------------------------------------D-----DDDDDDD------------------------D----------------------------
------------------------------------------------------------------------------------D-----------D------------------------D----------------------------
--------!--!------------------------------------------------------------------------D-----------D------------------------D----------------------------
----------------------------------------------------------------------------DDTT------k-k-------D---------------------D--D--------------------o--o----
-----------------------------------------------------------------oo---------DDtt--TT-DDDDD------D--------------------DD--D----------------------------
X-------!--!--------------------------------X--------------D------------oX----tt--tt-------X--ooD---------o-------oo--D--D----------------------------
X-------------------------------------------X---------------------------oX----tt--tt-------X--ooD---------o-------TT--D--D------o-------------#-------
X--M---------------------------------------XX---------------------------XX----tt--tt-------X---o----------o-------tt--D--D-----o-o----------g##-------
XXXXXoXXoXXoXX-----------------XXX--XXXXX-XXX----------TT----XXX----XX--XX----tt--tt-------X---o--------o-o--oo-------D--D----o-o-o---------###-------
XXXXXXXXXXXXXX---------------X-XXX--XXXXX-XXX----------tt----XXX----XX--XX----tt--tt-------X------------D-o--TT-------D--DDDDDDDDDDDDD----g####-------
XXXXXXXXXXXX---------TT-----XX-------------oX------TToott------X---------X----tt--tt-------X--------------o--tt---oo--D-------------------#####-------
XXXXXXXXX-----------otto-----XX------------oX------ttoott---X--X---------X----tt--tt-------X---------o----o-------TT--D-----------------g######-------
XXXXXX--------------otto-----XX------------oX------ttoott---X--X---------X----tt--tt-------X---------D------------tt--D-------TT--------#######----F--
XXX------------X-X--otto--X-X---------g----oX------ttggtt------X---------X----tt--tt-------X------------------g---tt--D-------tt-------########----#--
XX-------------XXXXXXXXXXXXXXXXXXX--XXXXX-XXXXXXXXXXXXXXXXXXXXXX---------X----tt--tt-------X---DD--------X---XX-X--XX-XX--TT--tt---TT--XXXXXXXXXXXXXXX
X--------------XXXXXXXXXXXXXXXXXXX--XXXXX-XXXXXXXXXXXXXXXXXXXXXX---------X----tt--tt-------X-------------X---XX-X--XX-XXX-tt--tt---tt--XXXXXXXXXXXXXXX
