-------------------------------------------------------------------X----------------------------------------------------------------------------------
-------------------------------------------------------------------X--------------------L-------------------------------------------------------------
-------------------------------------------------------------------X----------------------------------------------------------------------------------
---M---X--gX-g-----------------------------------------------------X-------------------K------------------------------D-------------------------o-----
XXXXXXXXXXXXXX--X------------------------------------------g-X------X---------------%%%%%----------------------------DD------------------------o------
XXXXXXXXXXXXXX--XXX----XXX-------------------------------DDD-XX---XXXX----X---------%%%%%-----------------o-------oo--D-----------------------o-------
-------------X--XXX----XXXX----------------------------TTDD--XX---XXXXX--XX-----------||------------------o-------TT--D-----------------------#-------
-------------X--XXXX---XXXX----------------------------tt----XX---XXXXX---X---k---k---||------------------o-------tt--D---------------D------##-------
----------------XXX----XXXX----------------------g-g---tt----XX--oXXXXX---X-%%%%%%%%%%%%%-----------------o--oo-------D----------------------##-------
----------------XXX---XXXXX-----------------XXXXXXXXTTXXXXXX-XX--oXXXXXX--X-%%%%%%%%%%%%%---------o-------o--TT-------D--------o----D-----o--##-------
-D-D-DD--D-D-DD-XXX----XXXXX--------TT-----XXXXXXXXXttXXXXXX-XX---o-------X-------||--------------o-------o--tt---oo--D--------o----------#--##-------
-D-D-D-D-D-D-D--XXXX---XXXXXX------otto-----X-------tt-------XX---o-------X-------||--------------o-------o-------TT--D--------o------D--##--##-------
-DD--DD--D-D-DD-XXX----XXXXXX------otto-----X-------tt-------XX---XXX-XXXXX-------||--------------o---------------tt--D--------o------D--##--##----F--
-D-D-D-D--D---D-XXX---XXXXXXXXX-X--otto--X-X--------tt-------XX----XX-XXXXX-------||--------------o-----------g---tt--D-D------r------D#-##--##----#--
-D-D-D-D--D--DD-XXXooooXXXXXXXXXXXXXXXXXXXXXX-------tt-------XX----XX-XXXXX-------||------X-------X-----XX---XX-X--XX-XXXXX----D----XXXX-XX--XXXXXXXXX
----------------XXXXXXXXXXXXXXXXXXXXXXXXXXXXX-------tt-------XX----XX-XXXXX-------||------X-------X-----XX---XX-X--XX-XXXXX---------XXXX-XX--XXXXXXXXX
