------------------------------------------------------------------------------------------------------------------------------------------------------
-------------------------------------------------------------------------L----------------------------------------------------------------------------
------------------------------------------------------------------------------------------------------------------------------------------------------
------------------------------------------------------------------------K-----------------------------------------------------------------------o-----
---------------------------------------------------------------------%%%%%---------------------------------------------------------------------o------
---------------------------------------------------------------------%%%%%--------------------------------------------------------------------o-------
o----------------------------------------------------------------------||----------------o----------------------------------------------------#-------
X----------------------------------------------------------D---k---k---||----------------o---------------------------------------------------##-------
X------------------------------------------------------------%%%%%%%%%%%%%---------------o---------------------------------------------------##-------
X--------o------------------------------------------o----D---%%%%%%%%%%%%%---------------D--------o--------------o------------------------o--##-------
X--------o------------------------------------------o--------------||--------o--------------------o--------------o------------------------#--##-------
X--------o------------C-S-S-C-----------------------o------D-------||--------o----------*---------o--------------o-------------C-S-S-C---##--##-------
XX-----------------------------D-----*-----D--------o------D-------||--------o-------*--D---------o--------------o-----------------------##--##----F--
XX-M-D--gD-gD-g-------ooo------D-----D-----D-D------r------D-------||-----------g--g-D--D---------o--------------o-------------ooo-----#-##--##----#--
XXXXXXXXXXXXXXXXXXX--XXXXX-XXXXXXXXXXXXXXXXXXXXX----D----XXX-------||------XXXXXXXXXXXXXXXX-------X-----XX-------X-----XXXXX--XXXXX-XXXX-XX--XXXXXXXXX
XXXXXXXXXXXXXXXXXXX--XXXXX-XXXXXXXXXXXXXXXXXXXXX---------XXX-------||------XXXXXXXXXXXXXXXX-------X-----XX-------X-----XXXXX--XXXXX-XXXX-XX--XXXXXXXXX
