----------------------------------------------D------------D----------------D------------D-D------------D-D-------------------------------------------
----------------------------------------------D------------D----------------D------------D-D------------D-D-------------------------------------------
----------------------------------------------D------------D----------------D------------D-D------------D-D-------------------------------------------
---M---X--gX-g--------------------------------D------------D----------------D------------D-D------------D-D-----------------------------------o--o----
XXXXXXXXXXXXXX--------------------------------D------------D----------------D------------D-D------------D-D-------------------------------------------
XXXXXXXXXXXXXX---------------X----------------D------------D----------------D------------D-D------------D-D-------------------------------------------
-------------X---------------X----------------D------------D----------------D------------D-D------------D-D-----------------------------------#-------
-------------X--------------XX----------------D------------D----------------D------------D-D------------D-D---------------------------------g##-------
----------------XXX--XXXXX-XXX----oooo-----g--D------------D-------D--------D------------D-D------------D-DDDDDDDDDDD-----------------------###-------
----------------XXX--XXXXX-XXX##--####--#####-D------------D--SSS@SSSS---D--D------------D-D------------D-----------------------o---------g####-------
-D-D-DD--D-D-DD-------------oX-#-y#--#-y#-----DDDDDDDDDDDDD----------S---D--DDDDDDDDDDDDD--DDDDDDDDDDDDD------------------------o---------#####-------
-D-D-D-D-D-D-D-X------------oX--##----##-----------oo-----------------SSSD-------oo-------------oo------------o--------Y--------o-------g######-------
-DD--DD--D-D-DDX------------oX--------------------------------oo-------ooD------------------------------------o--------Y--------o-------#######----F--
-D-D-D-D--D---D--------g----oX----------------k--y----y-------oo--g----ooD--k--y----y------k--y----y----------o-----Dy-D--------o------########----#--
-D-D-D-D--D--DDXXXX--XXXXX-XXX---------------XXXXXXXXXXXXXXXXXXXXXXXXXXXXXXXXXXXXXXXXXXXXXXXXXXXXXXXXXXXXX----X-----XXXXX-------X-----XXXXXXXXXXXXXXXX
---------------XXXX--XXXXX-XXX---------------XXXXXXXXXXXXXXXXXXXXXXXXXXXXXXXXXXXXXXXXXXXXXXXXXXXXXXXXXXXXX----X-----XXXXX-------X-----XXXXXXXXXXXXXXXX
