----------------D-------------------------------------------------U--------------------------------------DD-------------------------------------------
----------------D-----------------------------------------------------------------------------------------D-------------------------------------------
--------!--!----D-------------------------------------------------D---------------------------------------D-------------------------------------------
----------------D------------D--------------------------------------D-------------------------------------D-------------------------------------o-----
----------------D*-----------D-X----------------------------------D---------------------------------------D------------------------------------o------
--------!--!----DD----------DD-XXX----XXX---------------------------D-------------------------------------D-----------------------------------o-------
----------------D---------D--D-XXX----XXXX-----------------o------D---------------------------------------D-----------------------------------#-------
---M---------k---------------D-XXXX---XXXX-----------------o---r------r-----------------------------------D----------D-----------------------##-------
XXXXXXXXXXXXXX-----k----k----D-XXX----XXXX-----------------o%%%%%%%%%%%%%%%-------------------------------D----------------------------------##-------
XXXXXXXXXXXXXX--XXXXXXXXXXXXXX-XXX---XXXXX-----------------D%%%%%%%%%%%%%%%-----------------------o-------DDDDDDDDDDDD--------------------o--##-------
----------------XXXXXXXXXXXXXX-XXX----XXXXX----o-------------------||-----------------------------o----------------D---X-------o-----*D---#--##-------
-------------------------------XXXX---XXXXXX---o----------*--------||-------------C-S-S-C---------o-------o--------D---X-------o----ooD--##--##-------
-------------------------------XXX----XXXXXX---o-------*--D--------||-----------------------------o-------*----------o-Xo------o----DDD--##--##----F--
-------------------------------XXX---XXXXXXXX-----g--g-D--D--------||-------------ooo-------------o-------D----r-----*-Xo------g-----*D#-##--##----#--
-------------------------------XXXooooXXXXXXXXXXXXXXXXXXXXXX-------||------XXXX--XXXXX-XXXX-------X-----XXXXXXXXXXXXXXXXX------X-----XXX-XX--XXXXXXXXX
-------------------------------XXXXXXXXXXXXXXXXXXXXXXXXXXXXX-------||------XXXX--XXXXX-XXXX-------X-----XXXXXXXXXXXXXXXXX------X-----XXX-XX--XXXXXXXXX
