----------------------------------------------D------------D-------------------------------D-----------------------------D------------D---------------
----------------------------------------------D------------D-------------------------------D-----------------------------D------------D---------------
-----------------------------#----------------D------------D-------------------------------D-----------------------------D------------D---------------
-----------------------------#----------------D------------D-------------------------------D-----------------------------D------------D---------------
----------------------------------------------D------------D-------------------------------D-----------------------------D------------D---------------
--------------------------#-------------------D------------D-------------------------------D-----------------------------D------------D-------o-------
--------------------------#-------------------D------------D-----------------------------D-D-----------------------------D------------D-------#-------
--------------------------#-------------------D------------D----------------------------YD-D-----------------------------D------------D------##-------
X------o--o------------------#----------------D------------D------o---------------------DD-DDDDDDDDDDD-------------------D------------D----o-##-------
X------o--o------------------#----------------D------------D-----o-o---------------------D-----------D-----------o-------D------------D----#-##-------
X----------------------------#----------------DDDDDDDDDDDDD-----o-o-o--------------g-g-g-D-----------D--Y--------o-------DDDDDDDDDDDDD----##-##-------
X------!--!-----------oo----##-------C-S-S-C-------oo-------K--o-o-o-o--K------DDDDDDDDDDD-------------oo--------o------------oo---------###-##-------
X-----------------#---##---###------------------------------D---D---D---D-----D----------D-------------oo--------o---------------------o-###-##----F--
X--M--------g-gX--#--y--y--###-------ooo------k--y----y-------D---D---D------D-----------D---XyX-XyXyX-oo--------o-------k--y----y-----#-###-##g--g#--
XXXXXXXXXXXXXXXXXXXXXXXXXXXXXXXXXX--XXXXX-XXXXXXXXXXXXXXXXXXXXXXXXXXXXXXXXXXXXXXXXXXXXXXXXX--XXX-XXXXX-XXX-------X-----XXXXXXXXXXXXXXXXX-XXX-XXXXXXXXX
XXXXXXXXXXXXXXXXXXXXXXXXXXXXXXXXXX--XXXXX-XXXXXXXXXXXXXXXXXXXXXXXXXXXXXXXXXXXXXXXXXXXXXXXXX--XXX-XXXXX-XXX-------X-----XXXXXXXXXXXXXXXXX-XXX-XXXXXXXXX
