-------------------------------------------------------------D------------D----------------D------------D-D-------------------------------------------
-------------------------------------------------------------D------------D----------------D------------D-D-------------------------------------------
--------!--!-------------------------------------------------D------------D----------------D------------D-D-------------------------------------------
-------------------------------------------------------------D------------D----------------D------------D-D-----------------------------------o--o----
-------------------------------------------------------------D------------D----------------D------------D-D-------------------------------------------
--------!--!--------------------------------X----------------D------------D----------------D------------D-D-------------------------------------------
--------------------------------------------X--------------D-D------------D----------------D------------D-D---------------------------D-------#-------
---M---------k-----------------------------XX-------------YD-D------------D----------------D------------D-D--------------------------YD-----g##-------
XXXXXXXXXXXXXX-----oooo-----g--XXX--XXXXX-XXX-------------DD-D------------D------o---------D------------D-DDDDDDDDDDD----------------DD-----###-------
XXXXXXXXXXXXXX-##--####--#####-XXX--XXXXX-XXX--------------D-D------------D-----o-o--------D------------D-----------------------------D---g####-------
----------------#-y#--#-y#-----------------oX--------g-g-g-D-DDDDDDDDDDDDD-----o-o-o-------DDDDDDDDDDDDD------------------------g-g-g-D---#####-------
-----------------##----##-----X------------oX----DDDDDDDDDDD------oo-------K--o-o-o-o--K--------oo------------o--------Y----DDDDDDDDDDD-g######-------
------------------------------X------------oX---D----------D---------------D---D---D---D----------------------o--------Y---D----------D-#######----F--
--------------------------------------g----oX--D-----------D-k--y----y-------D---D---D-----k--y----y----------o-----Dy-D--D-----------D########----#--
------------------------------XXXX--XXXXX-XXXXXXXXXXXXXXXXXXXXXXXXXXXXXXXXXXXXXXXXXXXXXXXXXXXXXXXXXXXXXXXX----X-----XXXXXXXXXXXXXXXXXXXXXXXXXXXXXXXXXX
------------------------------XXXX--XXXXX-XXXXXXXXXXXXXXXXXXXXXXXXXXXXXXXXXXXXXXXXXXXXXXXXXXXXXXXXXXXXXXXX----X-----XXXXXXXXXXXXXXXXXXXXXXXXXXXXXXXXXX
