-------------------------------D------------D-------------------------------D------------DDD--------------D-------------------------------------------
-------------------------------D------------D-------------------------------D------------D-D--------------D-------------------------------------------
--------!--!-------------------D------------D-------------------------------D------------D-D--------------D-------------------------------------------
-------------------------------DD----*----DD--------------------------------D------------D-D--------------D-------------------------------------o-----
-----------------------------g-------D--------------------------------------D------------D-D--------------D------------------------------------o------
--------!--!---------------DDD-------D--------------------------------------D------------D-D--------------D-----------------------------------o-------
-------------------------TTDD--XXXXXXXXXXXXX---------------o----------------D*-----------D-D--------------D------o----------------------------#-------
---M---------k-----------tt--------------------------------o--------------o--------------D-D----------D---D-----o-o--------------------------##-------
XXXXXXXXXXXXXX-----g-g---tt--------------------------------o--------------D-X*-----------D-D--------------D----o-o-o-------------------------##-------
XXXXXXXXXXXXXX-XXXXXXXTTXXXXXX-----------------------------D--------------D-XX*------k---D-DDDDDDDDDDDD---DDDDDDDDDDDDD-------------------o--##-------
---------------XXXXXXXttXXXXXX-----------------o--------------o-------------XXXXXXXXXXXXo-----------D---X---------------------------------#--##-------
----------------------tt-----------------------o----------*---o----------*-------------Xo--o--------D---X--------------------------------##--##-------
----------------------tt-----------------------o-------*--D---o-------*--D-------------Xo--*----------o-X------TT--------D-----*-----D---##--##----F--
----------------------tt--------------------------g--g-D--D-------k---D--D-------------Xo--D----r-----*-X------tt--------D-----D-----D-#-##--##----#--
----------------------tt---------------------XXXXXXXXXXXXXXXXXXXXXXXXXXXXXX------------XXXXXXXXXXXXXXXXXX--TT--tt---TT--XXXXXXXXXXXXXXXX-XX--XXXXXXXXX
----------------------tt---------------------XXXXXXXXXXXXXXXXXXXXXXXXXXXXXX------------XXXXXXXXXXXXXXXXXXX-tt--tt---tt--XXXXXXXXXXXXXXXX-XX--XXXXXXXXX
