DD-------------
-D-------------
-D-------------
-D-------------
-D-------------
-D-------------
-D-------------
-D----------D--
-D-------------
-DDDDDDDDDDDD--
----------D---X
-o--------D---X
-*----------o-X
-D----r-----*-X
XXXXXXXXXXXXXXX
XXXXXXXXXXXXXXX