---------------
---------------
---------------
---------------
---------------
---------------
---------------
--------------o
--------------D
--------------D
--o------------
--o----------*-
--o-------*--D-
------k---D--D-
XXXXXXXXXXXXXXX
XXXXXXXXXXXXXXX