-D------------D
-D------------D
-D------------D
-D------------D
-D------------D
-D------------D
-D*-----------D
--------------D
-X*-----------D
-XX*------k---D
-XXXXXXXXXXXXo-
------------Xo-
------------Xo-
------------Xo-
------------XXX
------------XXX