-D-------------
-D-------------
-D-------------
-D------------D
-D*-----------D
-DD----------DD
-D---------D--D
--------------D
----k----k----D
-XXXXXXXXXXXXXX
-XXXXXXXXXXXXXX
---------------
---------------
---------------
---------------
---------------