------DD-------
------DD-------
------DD-------
------DD-------
------DD-------
------DD-------
------DD-------
------DD-------
------DD-------
-XX---DD----XX-
-XX---DD----XX-
-D----------D--
-D---------*D--
-D*--oooo--D---
--DDDDDDDDD----
---------------