DDDDDDD--------
------D--------
------D--------
------D--------
------D--------
-X--ooD--------
-X--ooD--------
-X---o---------
-X---o--------o
-X------------D
-X-------------
-X---------o---
-X---------D---
-X-------------
-X---DD--------
-X-------------