---------------
---------------
---------------
---------------
---------------
---------------
---------------
---------------
---------------
---------------
---------------
-------C-S-S-C-
---------------
-------ooo-----
XXXX--XXXXX-XXX
XXXX--XXXXX-XXX