---------------
---------------
---------------
---------------
-----oo--------
------------oX-
------------oX-
------------XX-
-XXX----XX--XX-
-XXX----XX--XX-
---X---------X-
X--X---------X-
X--X---------X-
---X---------X-
XXXX---------X-
XXXX---------X-