---------------
---------------
---------------
---------------
---------------
---------------
---------------
-------------o-
-X-----------2X
-X------------X
-X-----------oX
-X-----------2X
-X------------X
-X-r-----r----X
XXXX--XX-XX-XXX
XXXX--XX-XX-XXX