-D-------------
-D-------------
-D-------------
-D-------------
-D-------------
-D-------------
-D------o------
-D-----o-o-----
-D----o-o-o----
-DDDDDDDDDDDDD-
---------------
---------------
------TT-------
------tt-------
--TT--tt---TT--
X-tt--tt---tt--