---------------
---------------
---------------
---------------
---------------
---------------
-----o---------
----Xo---------
----Xo---------
-XXXXXTTXXXXXX-
-XXXXXttXXXXXX-
------tt-------
------tt-------
------tt-------
------tt-------
------tt-------
