---------------
---------------
--------------#
--------------#
---------------
-----------#---
-----------#---
-----------#---
--------------#
--------------#
--------------#
-------oo----##
---#---##---###
X--#--y--y--###
XXXXXXXXXXXXXXX
XXXXXXXXXXXXXXX