-D------------D
-D------------D
-D------------D
-D------------D
-D------------D
-D------------D
-D------------D
-D------------D
-D------------D
-D------------D
-DDDDDDDDDDDDD-
------oo-------
---------------
-k--y----y-----
XXXXXXXXXXXXXXX
XXXXXXXXXXXXXXX