---------------
---------------
---------------
---------------
---------------
---------------
--------------D
-------------YD
-------------DD
--------------D
--------g-g-g-D
----DDDDDDDDDDD
---D----------D
--D-----------D
XXXXXXXXXXXXXXX
XXXXXXXXXXXXXXX