-----D----D----
-----D----D----
-----D----D----
-----D----D----
-----Do--oD----
-----Do--oD----
---------------
---------------
---#y-#--#y-#--
#--####--####--
---------------
---------------
---------------
---------------
---------------
---------------