---------------
---------------
------------YYY
------------DDD
--------------D
--------------D
------------D-D
------------o-D
----ooo-----o-D
-DD-DDDD-DDDDDD
---------------
---------------
---------------
---------------
---------------
---------------