-D------------D
-D------------D
-D------------D
-D------------D
-D------------D
-D------------D
-D------------D
-D------------D
-D------------D
-D----oo-----oD
-D-----------*D
-Do---TT-------
-D*---tt--oo---
------tt-------
XXXX--tt--TT-XX
X-----tt--tt---