------tt-------
------tt-------
------tt-------
DD----TT-------
-------------o-
-------------o-
--TT---------o-
--tt---------o-
--tt-----D---D-
--tt---------D-
--DD---------D-
----D--------D-
----DTTTTTTTTD-
----DttttttttD-
----DDDDDDDDDD-
---------------