-------------*D
-------------oD
-------------oD
-------------*D
-D----Y--yYDo--
-DDDDDDDDDDDo--
-----------Do--
-----------Do--
-----------Do--
-----------DDDD
---------------
---------------
---------------
---------------
---------------
---------------
