-D-------------
-D-------------
-D-------------
-D-------------
-D-------------
-D-----o-------
-D----o-o------
-D---o-o-o--D--
-DDDDDDDDDDDDo-
-------------oD
X------------oD
X*-----------DD
X*------------X
X---y-----y---X
XXXXXXXXXXXXXXX
XXXXXXXXXXXXXXX