-D-------------
-D-------------
-D-------------
-D-------------
-D-------------
-D-------------
-D-------------
-D-------------
-DDDDDDDDDDD---
-----------D---
-----------D--Y
-------------oo
-------------oo
---XyX-XyXyX-oo
X--XXX-XXXXX-XX
X--XXX-XXXXX-XX