---------------
---------------
---------------
---------------
-------------YD
------------TTD
--------TT--ttD
------y-tty-ttD
-DDTTDDDttDDttD
---tt---tt--tt-
---tt---tt--tt-
---tt---tt--tt-
---tt---tt--tt-
---tt---tt--tt-
---tt---tt--tt-
---tt---tt--tt-